The Project Gutenberg eBook of List of post offices in Canada, with the names of the postmasters ... 1856
    
This ebook is for the use of anyone anywhere in the United States and
most other parts of the world at no cost and with almost no restrictions
whatsoever. You may copy it, give it away or re-use it under the terms
of the Project Gutenberg License included with this ebook or online
at www.gutenberg.org. If you are not located in the United States,
you will have to check the laws of the country where you are located
before using this eBook.

Title: List of post offices in Canada, with the names of the postmasters ... 1856

Author: Canada. Post Office Department

Release date: August 15, 2022 [eBook #68757]
                Most recently updated: October 18, 2024

Language: English

Original publication: Canada: Lovell and Gibson, 1856

Credits: WebRover, Adrian Mastronardi, The Philatelic Digital Library Project and the Online Distributed Proofreading Team at https://www.pgdp.net (This file was produced from images generously made available by The Internet Archive/Canadian Libraries)


*** START OF THE PROJECT GUTENBERG EBOOK LIST OF POST OFFICES IN CANADA, WITH THE NAMES OF THE POSTMASTERS ... 1856 ***

Transcriber’s Note: A large number of obvious printer’s errors have been
corrected, mostly around punctuation and accents, but more or less no
attempt has been made to standardise the varying spelling of the names of
people and places.




                                   LIST
                                    OF
                               POST OFFICES
                                    IN
                                 CANADA,
                                 WITH THE
                        NAMES OF THE POSTMASTERS,
                                    ON
                         THE 1st SEPTEMBER, 1856.

              WITH A SUPPLEMENTARY LIST TO 1st MARCH, 1857,
                                INCLUSIVE.

              _PRINTED BY ORDER OF THE POSTMASTER GENERAL._

                              [Illustration]

                                 TORONTO:
               PRINTED BY LOVELL AND GIBSON, YONGE STREET,
                                  1856.




(_Memorandum._)


                                                   POST OFFICE DEPARTMENT,
                                                   1st September, 1856.

Postmasters will correct their Lists by the Notices of Post Office
Operations, with which they will be furnished from time to time; and
should any Postmaster discover an error in the description of his Office,
as set forth in this List, he will please notify the same to this
Department.

_The Offices whose names are printed in Italics are authorized to grant
and pay Money Orders._




PRINCIPAL OFFICERS OF THE POST OFFICE DEPARTMENT.


  HONBLE. ROBERT SPENCE   _Post Master General._
  WILLIAM HENRY GRIFFIN   _Secretary._
  EDWIN JAMES KING        _Accountant._
  PETER LESUEUR           _Superintendent Money Order Branch._
  EDWIN FRANCIS KING      _Chief Clerk._
  JOHN ASHWORTH           _Cashier._


INSPECTORS.

                                          _Station._
  EDWARD S. FREER      Montreal Division   Montreal.
  JOHN DEWE            Toronto  do         Toronto.
  H. A. WICKSTEED      Kingston  do        Kingston.
  GILBERT E. GRIFFIN   London  do          London.




LIST OF POST OFFICES IN CANADA, AND THE NAMES OF THE POSTMASTERS,

ON THE 1ST SEPTEMBER, 1856.

_The Offices whose names are printed in Italics are authorized to grant
and pay Money Orders._


  ====================+===============+=================+=================
                      |TOWNSHIP IF IN |                 |
                      | CANADA WEST,  |                 |
                      | AND TOWNSHIP, |                 |
                      | SEIGNIORY OR  |                 |
                      |PARISH, IF IN  |ELECTORAL COUNTY |  NAME OF
  NAME OF POST OFFICE.| CANADA EAST.  |  OR DIVISION.   | POSTMASTER.
  --------------------+---------------+-----------------+-----------------
                      |               |                 |
  Abbott’s Corners    |               |Missisquoi       |H. H. Smith
  Abbottsford         |               |Rouville         |Ebenezer Fisk
  Abercorn            |Sutton         |Brome            |Benjamin Seaton
  Aberfoyle           |Puslinch       |Wellington, S. R.|S. Falconbridge
  Acton               |Esquesing      |Halton           |L. McDonald
  Acton Vale          |Acton          |Bagot            |Charles Beauregard
  Adamsville          |Farnham        |Brome            |George Adams
  Addison             |Elizabethtown  |Town of          |Coleman Lewis
                      |               |  Brockville     |
  Adelaide            |Adelaide       |Middlesex, W. R. |John S. Hoare
  Admaston            |Adamston       |Renfrew          |Archibald
                      |               |                 |  Patterson
  Adolphustown        |Adolphustown   |Lenox            |J. J. Watson
  Albion              |Albion         |Peel             |Samuel Walford
  Aldboro’            |Aldboro’       |Elgin, W. R.     |John McDougall
  Alexandria          |Lochiel        |Glengary         |Alexander McDonell
  Alfred              |Alfred         |Prescott         |John Hill
  Allanburg           |Thorold        |Welland          |John Rannie
  Allan Park          |Bentinck       |Grey             |G. B. Allan
  Allan’s Corners     |Durham         |Chateauguay      |William Allan
  _Allansville_       |Peel           |Wellington, N. R.|George Allan
  Allisonville        |Ameliasburg    |Prince Edward    |Royal C. Hicks
  Allumette Island    |Allumette      |Pontiac          |John Lynch
                      |  Island       |                 |
  Alma                |Peel           |Wellington, N. R.|Thomas Graham
  Alnwick             |Alnwick        |Northumberland,  |Robt. Mulholland
                      |               |  W. R.          |
  Alton               |Caledon        |Peel             |John S. Meek
  Altona              |Pickering      |Ontario, S. R.   |Joseph Monkhouse
  Alvinston           |Brooke         |Lambton          |John Brannan
  Ameliasburg         |Ameliasburg    |Prince Edward    |Owen Roblin
  _Amherstburg_       |Malden         |Essex            |James Kevill
  Amherst Island      |Amherst Island |Addington        |William Scott
  Amiens              |Lobo           |Middlesex, W. R. |H. P. Fuller
  Ancaster            |Ancaster       |Wentworth, S. R. |G. B. Rousseaux
  Ancienne Lorette    |Quebec         |Quebec           |Michel Gauvin
  Angus               |Essa           |Simcoe, S. R.    |J. B. Curtis
  Arlington           |Adjala         |Simcoe, S. R.    |Thos. Kidd
  Arnprior            |McNab          |Renfrew          |Andrew Russell
  Arran               |Arran          |Bruce            |John Morton
  Artemesia           |Artemesia      |Grey             |John Sproul
  Arthabaska          |Arthabaska     |Arthabaska       |Philip N. Pacaud
  Arthur              |Arthur         |Wellington, N. R.|Andrew Mitchell
  Arva                |London         |Middlesex, E. R. |Joseph Sifton
  Ashburn             |Whitby         |Ontario, S. R.   |James Lawder
  Ashfield            |Ashfield       |Huron            |Joseph Cline
  Ashgrove            |Esquesing      |Halton           |John Hunter
  Ashton              |Goulbourn      |Carleton         |John Sumner
  Asphodel            |Asphodel       |Peterborough     |J. S. Fowlds
  Athelstan           |Hinchinbrooke  |Huntingdon       |James Anderson
  Atherly             |Mara           |Ontario, N. R.   |W. McMullan
  Athlone             |Adjala         |Simcoe, S. R.    |Joseph Kidd
  Athol               |Indian Reserve |Glengary         |James McDonell
  Auburn              |Colborne       |Huron            |W. B. Garratt
  Aughrim             |Euphemia       |Lambton          |John McKenne
  Aultsville          |Oznabruck      |Stormont         |J. R. Ault
  _Aurora_            |Whitchurch     |York, N. R.      |Charles Doan
  Avon                |Dorchester, N. |Middlesex, E. R. |Simon Whaley
  Avon Bank           |Downie         |Perth            |James Muir
  _Aylmer (East)_     |Hull           |Ottawa           |J. R. Woods
  Aylmer (West)       |Malahide       |Elgin, E. R.     |Philip Hodgkinson
  Aylwin              |Aylwin         |Ottawa           |J. Little
  _Ayr_               |Dumfries       |Waterloo, S. R.  |Robert Wyllie
                      |               |                 |
                      |               |                 |
  Baby’s Point        |Sombra         |Lambton          |James Menton
  Babyville           |Sherrington    |Napierville      |Humphrey Nesbitt
  Baden               |Wilmot         |Waterloo, S. R.  |Jacob Beck
  Bagot               |Bagot          |Renfrew          |Gerrard McCrea
  Bagotville          |               |Chicoutimi       |L. Z. Rousseau
  Ballinafad          |Erin           |Wellington, S. R.|James Campbell
  Ballycroy           |Adjala         |Simcoe, S. R.    |Peter Small
  Balmoral            |Walpole        |Haldimand        |Lewis Anguish
  Baltimore           |Hamilton       |Northumberland,  |Robert Harstone
                      |               |  W. R.          |
  Bandon              |Hullett        |Huron            |John Warwick
  Barnett             |Nichol         |Wellington, N. R.|James Elmslie
  Barnston            |Barnston       |Stanstead        |John Humphrey
  _Barrie_            |Vespra         |Simcoe, N. R.    |Jonathan Lane
  _Bath_              |Ernestown      |Addington        |W. J. Fairfield
  Batiscan            |Batiscan       |Champlain        |J. B. F. Filteau
  Batiscan Bridge     |Do.            |Do.              |J. Fugère
  Battersea           |Storrington    |Frontenac        |Cornelius Vanluven
  _Bayfield_          |Stanley        |Huron            |James Gairdner
  Bayham              |Bayham         |Elgin, E. R.     |Thomas Springall
  _Beachville_        |Oxford, W.     |Oxford, S. R.    |William Hook
  _Beamsville_        |Clinton        |Lincoln          |J. B. Osborne
  Bear Brook          |Cumberland     |Russell          |John Walsh
  Beauharnois         |Beauharnois    |Beauharnois      |Henry Bogue
  Beaumont            |Beaumont       |Bellechasse      |Z. Turgeon
  Beauport            |Beauport       |Quebec           |Alexis de Rouselle
  Beaverton           |Thorah         |Ontario, N. R.   |Donald Cameron
  Becancour           |Becancour      |Nicolet          |B. Rivard
  Bedford             |Stanbridge     |Missisquoi       |Nelson Adams
  Belfast             |Ashfield       |Huron            |Alexander McDonagh
  Belford             |Markham        |York, E. R.      |William Harper
  Belfountain         |Caledon        |Peel             |Thos. J. Bush
  Bellamy’s Mills     |Ramsay         |Lanark, N. R.    |Thomas Coulter
  Belle Rivière       |               |Two Mountains    |
  _Belleville_        |Thurlow        |Hastings, S. R.  |J. H. Meacham
  Bell Ewart          |Innisfil       |Simcoe, S. R.    |Edward Drake
  Bell’s Corners      |Nepean         |Carleton         |George Arnold
  Belmont             |Dorchester, S. |Elgin, E. R.     |James Waterberry
  Belmore             |Turnberry      |Huron            |F. W. Irvine
  Belœil              |Belœil         |Verchères        |J. R. Brillon
  Benmiller           |Colborne       |Huron            |Thomas Logan
  Bennie’s Corners    |Ramsay         |Lanark, N. R.    |Alex. Leishman
  _Bentinck_          |Bentinck       |Grey             |A. B. McNab
  _Berlin_            |Waterloo, N.   |Waterloo, N. R.  |Wm. Davidson
  Berthier, en bas    |Berthier       |Montmagny        |David Blouin
  _Berthier, en Haut_ |Berthier       |Berthier         |J. F. G. Coutu
  Bervie              |Kincardine     |Bruce            |Nichol McIntyre
  Beverley            |Bastard        |Leeds, S. R.     |J. A. Russell
  Bic                 |Bic            |Rimouski         |George Sylvain
  Biddulph            |Biddulph       |Huron            |John Cooney
  Binbrook            |Binbrook       |Wentworth, S. R. |Henry Hall
  Birmingham          |Pittsburg      |Frontenac        |James Birmingham
  Bishop’s Mills      |Oxford         |Grenville, N. R. |S. L. Bishop
  Black Creek         |Willoughby     |Welland          |A. McMurray
  Blandford           |Blandford      |Arthabaska       |Pierre Trepannier
  Bloomfield          |Hallowell      |Prince Edward    |Jonathan Striker
  Bloomsburg          |Townsend       |Norfolk          |M. M. Kitchen
  Blythe              |               |Huron            |J. Templeton
  Bobcaygeon          |Verulam        |Victoria         |Mossom Boyd
  Bodmin              |Morris         |Huron            |Wm. Harris
  Bond Head           |Tecumseth      |Simcoe, S. R.    |Mrs. St. Clair
  Bongard’s Corners   |Marysburg      |Prince Edward    |John Bongard
  Bosanquet           |Bosanquet      |Lambton          |Levi Schooley
  Boscobel            |Ely            |Shefford         |Wm. Hackwell
  Boston              |Townsend       |Norfolk          |Oliver C. Rouse
  Bothwell            |Zone           |Kent             |H. D. Munro
  Boucherville        |Boucherville   |Chambly          |Louis Normandin
  Bourg Louis         |Bourg Louis    |Portneuf         |Joseph Beer
  _Bowmanville_       |Darlington     |Durham, W. R.    |Robert Fairbairn
  _Bradford_          |W. Gwillimbury |Simcoe, S. R.    |George Douglas
  _Brampton_          |Chinguacousy   |Peel             |K. Chisholm
  Branchton           |Dumfries, S.   |Brant, E. R.     |Joseph Burrows
  Brant               |Brant          |Bruce            |Malcolm Maclean
  _Brantford_         |Brantford      |Brant, W. R.     |J. D. Clement
  Breslaw             |Waterloo       |Waterloo, N. R.  |Cyrus Erb
  Brewer’s Mills      |Pittsburg      |Frontenac        |Robert Anglin
  Brewster            |Hay            |Huron            |
  Bridgenorth         |Smith          |Peterboro’       |Marcus S. Dean
  Bridgeport          |Waterloo, N.   |Waterloo, N. R.  |P. N. Tagge
  _Brighton_          |Murray         |Northumberland,  |Joseph Lockwood
                      |               |  E. R.          |
  Bristol             |Bristol        |Pontiac          |William King
  Brock               |Brock          |Ontario, N. R.   |Thomas Hill
  Brock’s Creek       |Aldboro’       |Elgin, W. R.     |
  _Brockville_        |Elizabethtown  |Town of          |John Kilborn
                      |               |  Brockville     |
  Brome               |Brome          |Brome            |Henry R. Williams
  Brompton            |Brompton       |Richmond         |S. A. Stevens
  Brompton Falls      |Do.            |Do.              |James Dean
  Bronte              |Trafalgar      |Halton           |Elijah Williams
  Brooke              |Brooke         |Lambton          |George Shirleya
  _Brooklin_          |Whitby         |Ontario, S. R.   |Robert Darlington
  Brougham            |Pickering      |Ontario, S. R.   |Richard Taun
  Broughton           |Broughton      |Megantic         |C. H. J. Hall
  Brownsburg          |Chatham        |Argenteuil       |Alex. McGibbon
  Brown’s Corners     |Pickering      |Ontario, S. R.   |Thomas Palmer
  Brownsville         |Dereham        |Oxford, S. R.    |E. F. Brown
  Bruce               |Bruce          |Bruce            |Peter Sinclair
  Brucefield          |Stanley        |Huron            |Robert H. Gairdner
  Bruce Mines         |        On Lake|Huron            |John Pennefather
  Buckingham          |Buckingham     |Ottawa           |James Wilson
  _Burford_           |Burford        |Brant, W. R.     |Henry Kirkland
  Burgessville        |Norwich        |Oxford, S. R.    |John Tennant
  Burn-brae           |Seymour        |Northumberland,  |Alex. Donald
                      |               |  E. R.          |
  Burnstown           |McNab          |Renfrew          |A. H. Dowswell
  Burritt’s Rapids    |Marlborough    |Carleton         |John Meikle, Jr.
  Bute                |Somerset       |Megantic         |J. McKinnon
  Buttonville         |Markham        |York, E. R.      |Wm. Morrison
  Buxton              |Raleigh        |Kent             |
                      |               |                 |
                      |               |                 |
  Cacouna             |Cacouna        |Temiscouata      |J. B. Beaulieu
  Cæsarea             |Cartwright     |Durham, W. R.    |James Cæsar
  Cainsville          |Brantford, E.  |Brant, E. R.     |J. D. Dresser
  Caintown            |Yonge          |Leeds, S. R.     |Myles Young
  Caistor             |Caistor        |Lincoln          |James Tisdale
  Caistorville        |Caistor        |Lincoln          |David Tice
  Caledon             |Caledon        |Peel             |George Bell
  Caledon, East       |Caledon        |Peel             |Joseph McDougall
  Caledonia Flats     |Caledonia      |Prescott         |William Bradley
  Caledonia Springs   |Caledonia      |Prescott         |James Brock
  Calumet Island      |Calumet        |Pontiac          |Louis Brissard
  Cambray             |Fenelon        |Victoria         |Joseph Wilkinson
  Camden, East        |Camden, East   |Addington        |Samuel Clarke
  Campbellford        |Seymour        |Northumberland,  |James Boland
                      |               |  E. R.          |
  Campbell’s Cross    |Chinguacousy   |Peel             |F. M. Penny
  Campbellville       |Nassagaweya    |Halton           |James McLean
  Canboro’            |Canboro’       |Haldimand        |Wm. Fitch
  Canestoga           |Woolwich       |Waterloo, N. R.  |Charles Hendry
  Canfield            |Cayuga         |Haldimand        |John Willson
  Cannifton           |Thurlow        |Hastings, S. R.  |John Canniff
  Canning             |Blenheim       |Oxford, N. R.    |Thos. Allchin
  Cannington          |Brock          |Ontario, N. R.   |Charles Gibbs
  Canrobert           |               |Rouville         |James Malarkey
  Canton              |Hope           |Durham, E. R.    |Wm. Carr
  Cap Chat (sub       |               |Gaspé            |F. G. Lamontagne
    office)           |               |                 |
  Cape Cove           |Percé          |Gaspé            |William Tilley
  Cape Rich           |St. Vincent    |Grey             |Donald McLaren
  Cap St. Ignace      |               |Montmagny        |P. A. Larue
  Cap Santé           |Portneuf       |Portneuf         |G. A. Allsopp
  Carillon            |Chatham        |Argenteuil       |C. W. Schneider
  Carleton, (B. C.)   |Carleton       |Bonaventure      |Joseph Meagher
  _Carleton Place_    |Beckwith       |Lanark, S. R.    |Duncan Campbell
  Carlisle            |Flamboro’, East|Wentworth, N. R. |W. Lottridge
  Carlow              |Colborne       |Huron            |James McDonagh
  Carluke             |Ancaster       |Wentworth, S. R. |James Calder
  Carp                |Huntley        |Carleton         |Wm. Law
  Carronbrook         |Logan          |Perth            |U. C. Lee
  Carthage            |Mornington     |Perth            |Alexander McDonald
  Cartwright          |Cartwright     |Durham, W. R.    |Wm. Vance
  Castleford          |Horton         |Renfrew          |
  Castlemore          |Gore of Toronto|Peel             |John Murphy
  Castleton           |Cramahe        |Northumberland,  |John C. Pennock
                      |               |  E. R.          |
  Caughnawaga         |Sault St. Louis|Laprairie        |Robert McNabb
  Cathcart            |Burford        |Brant            |J. S. Lawrence
  Cavagnol            |Vaudreuil      |Vaudreuil        |R. B. Mathison
  Cavan               |Cavan          |Durham, E. R.    |John Knowlson
  _Cayuga_            |Cayuga         |Haldimand        |Duncan Campbell
  Cedar Grove         |Markham        |York, E. R.      |Saml. Harrington
  Cedars              |Soulanges      |Soulanges        |Benjamin Joassim
  Centre Augusta      |Augusta        |Grenville, S. R. |Horace McLean
  Centreville         |Camden, East   |Addington        |James N. Lapum
  _Chambly_           |West Chambly   |Chambly          |Thomas Hickey
  Champlain           |Champlain      |Champlain        |J. E. Lanouette
  Charlesbourg        |Quebec         |Quebec           |Joseph Lecourt
  Charleston          |Escott         |Leeds, S. R.     |P. F. Green
  Charleville         |Augusta        |Grenville, S. R. |Charles Lane
  Chateauguay         |Chateauguay    |Chateauguay      |George Burrell
  Chateau Richer      |Montmorency    |Montmorency      |L. O. Rousseau
  Chatham (East)      |Chatham        |Argenteuil       |George Bradford
  _Chatham (West)_    |Raleigh        |Kent             |B. F. Barfoot
  Chelsea             |Hull           |Ottawa           |Nicholas Link
  Cheltenham          |Chinguacousy   |Peel             |William Allan
  Cherry Creek        |Innisfil       |Simcoe, S. R.    |Wm. Main
  Cherry Valley       |Athol          |Prince Edward    |Isaiah T. Insley
  Chertsey            |Chertsey       |Montcalm         |Magloire Granger
  Chesterfield        |Blenheim       |Oxford, N. R.    |George Baird
  Chichester          |Chichester     |Pontiac          |John Poupore
  Chicoutimi          |Chicoutimi     |Chicoutimi       |John Guay
  _Chippawa_          |Stamford       |Welland          |Mrs. Hepburn
  Churchville         |Toronto        |Peel             |William Duggan
  Claremont           |Pickering      |Ontario, S. R.   |William McNab
  Clarence            |Clarence       |Russell          |Richard Woodley
  Clarenceville       |Noyan          |Iberville        |Charles Stewart
  Clarendon Centre    |Clarendon      |Pontiac          |James Shaw
  Clareview           |Sheffield      |Addington        |Archd. McDonald
  Clarke              |Clarke         |Durham, W. R.    |John Beavis
  Clear Creek         |Houghton       |Norfolk          |Jonathan Bridgman
  Clearville          |Orford         |Kent             |J. R. Bury
  Clifford            |Minto          |Wellington, N. R.|W. Brown
  [1]Clifton House    |Stamford       |Welland          |J. Shears
    (Sub.)            |               |                 |
  _Clinton_           |Tuckersmith    |Huron            |Thos. Fair
  Clover Hill         |Essa           |Simcoe, S. R.    |Robert Sproule
  Clunas              |Dorchester, S. |Elgin, E. R.     |Archd. Clunas
  _Coaticook_         |Barford        |Stanstead        |Horace Cutting
  Cobden              |Ross           |Renfrew          |Jason Gould
  _Cobourg_           |Hamilton       |Northumberland,  |Thomas Scott
                      |               |  W. R.          |
  Codrington          |Brighton       |Northumberland,  |Patrick O’Neill
                      |               |  E. R.          |
  Colborne            |Cramahe        |Do., E. R.       |Joseph A. Keeler
  Colchester          |Colchester     |Essex            |James Bell
  Coldsprings         |Hamilton       |Northumberland,  |D. McIntosh
                      |               |  W. R.          |
  Coldstream          |Lobo           |Middlesex, W. R. |Elias Cutler
  Coldwater           |Medonte        |Simcoe, N. R.    |James Shaw
  Colebrook           |Camden, East   |Addington        |Charles Warner
  Coleraine           |Toronto Gore   |Peel             |Thomas St. John
  Colinville          |Moore          |Lambton          |John Butler
  Collingwood         |Nottawasaga    |Simcoe, N. R.    |Peter Ferguson
  Collin’s Bay        |Kingston       |Frontenac        |Lawrence Herchmer
  Columbus            |Whitby         |Ontario, S. R.   |Robert Ashton
  Comer’s Mills       |Ernestown      |Addington        |Daniel W. Perry
  _Compton_           |Compton        |Compton          |A. W. Kendrick
  Concord             |Vaughan        |York, W. R.      |John Duncan
  Conry               |Downie         |Perth            |Wm. Conry
  Consecon            |Hillier        |Prince Edward    |Wm. Kirkland
  Contrecœur          |Contrecœur     |Verchères        |Olivier Lamoureux
  Cookshire           |Eaton          |Compton          |R. Wilford
  Cookstown           |Tecumseth      |Simcoe, S. R.    |James Harper
  Cooksville          |Toronto        |Peel             |F. B. Morley
  Copetown            |Beverley       |Wentworth, N. R. |Thomas Milne
  _Cornwall_          |Cornwall       |Town of Cornwall |G. C. Wood
  Corunna             |Moore          |Lambton          |H. J. Miller
  Coteau du Lac       |Soulanges      |Soulanges        |Louis Adams
  Coteau Landing      |Soulanges      |Soulanges        |John Bermingham
  Côte des Neiges     |Montreal       |Hochelaga        |R. Robertson
  Covey Hill          |Hemmingford    |Huntingdon       |Wm. Barrett
  Cowansville         |Durham         |Missisquoi       |Peter Cowan
  Cranbourne          |Cranbourne     |Dorchester       |John Keegan
  Credit              |Toronto        |Peel             |James Magrath
  Creek Bank          |Woolwich       |Waterloo, N. R.  |John Fisher
  Creemore Mills      |Nottawasaga    |Simcoe, N. R.    |E. Webster
  Crosby’s Corners    |Markham        |York, E. R.      |Arthur Alexander
  Crosshill           |Wellesley      |Waterloo, N. R.  |Jas. McCutcheon
  Crosspoint          |Restigouche    |Bonaventure      |John Fraser
  Croton              |Dawn           |Lambton          |J. H. Johnston
  Crowland            |Crowland       |Welland          |G. W. Cook
  Croydon             |Camden, E.     |Addington        |Carlos Mendell
  Culloden            |Dereham        |Oxford, S. R.    |Wm. Smith
  Cumberland          |Cumberland     |Russell          |G. G. Dunning
  Cumminsville        |Nelson         |Halton           |Wm. Panton
  Cumnock             |Nichol         |Wellington, N. R.|
                      |               |                 |
                      |               |                 |
  Daillebout          |De Ramsay      |Joliette         |Robert Turner
  Dalesville          |Rear of Chatham|Argenteuil       |Peter McArthur
  Dalhousie Mills     |Lochiel        |Glengary         |Donald W. McPhail
  Danville            |Shipton        |Richmond         |J. W. Stockwell
  Dartford            |Percy          |Northumberland,  |P. S. Dorland
                      |               |  E. R.          |
  Dawn Mills          |Gore of Camden |Kent             |James Smith
  Dealtown            |Raleigh        |Kent             |Joseph Smith
  De Cewsville        |Cayuga         |Haldimand        |William DeCew
  Delaware            |Delaware       |Middlesex, W. R. |S. M. Towle
  Delhi               |Middleton      |Norfolk          |Wm. McClellan
  Demorestville       |Sophiasburg    |Prince Edward    |John Howell
  Deniston            |Hinchinbrooke  |Frontenac        |William Dennison
  De Ramsay           |De Ramsay      |Joliette         |James Read
  _Dereham_           |Dereham        |Oxford, S. R.    |Lachlen McLean
  Derry West          |Toronto        |Peel             |William McClare
  Deschambault        |Deschambault   |Portneuf         |François Hamelin
  Devon               |Usborne        |Huron            |Joseph Quick
  Dewittville         |               |Huntingdon       |Joseph Oliver
  Dickenson’s Land’g  |Oznabruck      |Stormont         |William Colquhoun
  Dingle              |Grey           |Huron            |Wm. Grant
  Dixon’s Corners     |Matilda        |Dundas           |William Wood
  Doon                |Waterloo, N.   |Waterloo, N. R.  |Robert Strang
  Dorchester          |Dorchester, N. |Middlesex, E. R. |Thomas Putnam
  Dorchester Station  |Dorchester     |Do.              |L. M. Crosby
  Dougherty           |N. E. Hope     |Perth            |James Dougherty
  Douglas             |Bromley        |Renfrew          |Charles Coulter
  Douglastown         |Douglas        |Gaspé            |Charles Veit
  Downeyville         |Emily          |Victoria         |Michael Lehane
  Drayton             |Peel           |Wellington, N. R.|J. H. Hartney
  Dresden             |Gore of Camden |Kent             |George M. Webster
  Drew’s Mills        |Barford        |Stanstead        |A. T. Bangs
  Drumbo              |Blenheim       |Oxford, N. R.    |F. Blancher
  Drummondville, E.   |Grantham       |Drummond         |James Millar
  _Drummondville, W._ |Stamford       |Welland          |Samuel
                      |               |                 |  Falconbridge
  Dudswell            |Dudswell       |Wolfe            |Zerah Evans
  Dumblane            |Saugeen        |Bruce            |W. Wallace
  Dunany              |Wentworth      |Argenteuil       |Samuel Smith
  Dunbar              |Williamsburg   |Dundas           |Wm. Beckstedt
  Dunbarton           |Pickering      |Ontario, S. R.   |John Parker
  _Dundas_            |Flamboro’, West|Wentworth, N. R. |Patrick Thornton
  Dundee              |Godmanchester  |Huntington       |David Baker
  Dunham              |Dunham         |Missisquoi       |Edward Baker
  Dunkeld             |Brant          |Bruce            |Hugh Bell
  _Dunnville_         |Moulton        |Haldimand        |John Armour
  Durham              |Durham         |Drummond         |Robert More
                      |               |                 |
                      |               |                 |
  Eardley             |Eardley        |Ottawa           |Wyman C. Davis
  East Clifton        |Clifton        |Compton          |David Stone
  East Farnham        |Farnham        |Brome            |Rodney Hutchins
  East Frampton       |Frampton       |Dorchester       |James Kennedy
  East Glenelg        |Glenelg        |Grey             |Eliza L. Atkinson
  East Hawkesbury     |Hawkesbury     |Prescott         |James Gamble
  East Hereford       |Hereford       |Compton          |C. W. Prouty
  East Holland        |Holland        |Grey             |Henry Cardwell
  Easton’s Corners    |Wolford        |Grenville, N. R. |Heman McCrae
  East Oro            |Oro            |Simcoe, N. R.    |Wm. Simpson
  East Williamsburg   |Williamsburg   |Dundas           |Lindsay Pillar
  Eastwood            |Oxford, S.     |Oxford, S. R.    |Henry Vansittart
  Eaton               |Eaton          |Compton          |Joshua Foss
  Eden                |Bayham         |Elgin, E. R.     |John Mabee
  Eden Mills          |Eramosa        |Wellington, S. R.|Samuel Meadows
  Edmonton            |Chinguacousy   |Peel             |James
                      |               |                 |  Collingbourne
  Edwardsburg         |Edwardsburg    |Grenville, S. R. |William S. Aikin
  Eganville           |Gratton        |Renfrew          |
  Eglington           |York           |York, W. R.      |Joseph Hargrave
  Egmondville         |Tuckersmith    |Huron            |T. J. Marks
  Egremont            |Egremont       |Grey             |David Cochrane
  Ekfrid              |Ekfrid         |Middlesex, W. R. |Jonathan Miller
  Eldon               |Eldon          |Victoria         |Angus Ray
  Elgin               |S. Crosby      |Leeds, S. R.     |Philemon Pennock
  Elginburg           |Kingston       |Frontenac        |Peter Bates
  Elginfield          |London         |Middlesex, E. R. |Wm. Frank
  Elizabethville      |Hope           |Durham, E. R.    |J. McMurtry
  Ellesmere           |Scarboro’      |York, E. R.      |Arch. Glendinning
  Elma                |Elma           |Perth            |G. Code
  Elmgrove            |Essa           |Simcoe, S. R.    |George Latimer
  _Elora_             |Pilkington     |Wellington, N. R.|R. Haig
  Embro’              |Zorra W.       |Oxford, N. R.    |G. Matheson
  Emily               |Emily          |Victoria         |Robert Grandy
  Ennis               |Enniskillen    |Lambton          |Charles Little
  Enniskillen         |Darlington     |Durham, W. R.    |Thomas Ferris
  Enterprise          |Camden East    |Addington        |James Sherman
  Epsom               |Reach          |Ontario, N. R.   |Anson T. Button
  Eramosa             |Eramosa        |Wellington, S. R.|Robert Dryden
  Erin                |Erin           |Wellington, S. R.|William Cornock
  Erinsville          |Sheffield      |Addington        |Patrick Gafney
  Eroll               |Plympton       |Lambton          |George Whiting
  Escott              |Yonge          |Leeds, S. R.     |Thomas Vanston
  Esquesing           |Esquesing      |Halton           |Mrs. Richard Tracy
  _Etobicoke_         |Etobicoke      |York, W. R.      |William Gamble
  Euphrasia           |Euphrasia      |Grey             |Thomas J. Rorke
  Everton             |Eramosa        |Wellington, S. R.|Rufus Everts
  Exeter              |Stephen        |Huron            |William Sanders
                      |               |                 |
                      |               |                 |
  Fairview            |Zorra          |Oxford, N. R.    |John Armstrong
  Falkirk             |Williams       |Middlesex, W. R. |John H. Priestly
  Farmersville        |Yonge          |Leeds, S. R.     |Arza Parish
  Farnham Centre      |Farnham        |Brome            |John Johnston
  Fenelon Falls       |Fenelon        |Victoria         |T. S. Stayner
  Fenwick             |Pelham         |Welland          |Leonard Haney
  _Fergus_            |Nichol         |Wellington, N. R.|James McQueen
  Ferguson’s Falls    |Drummond       |Lanark, S. R.    |William Doran
  Fermoy              |Bedford        |Frontenac        |Edward Botting
  Finch               |Finch          |Stormont         |J. A. Cockburn
  Fingal              |Southwold      |Elgin, W. R.     |Levi Fowler
  Fish Creek          |Blanshard      |Perth            |John Bell
  Fitch Bay           |Stanstead      |Stanstead        |John Bell
  Fitzroy Harbor      |Fitzroy        |Carleton         |W. D. Pigott
  Flint               |Kaladar        |Addington        |John Lansing
  Florence            |Euphemia       |Lambton          |G. P. Kerby
  Flos                |Flos           |Simcoe, N. R.    |John Craig
  [2]Fonthill         |Pelham         |Welland          |John S. Price
  Forester’s Falls    |Ross           |Renfrew          |Oliver Forester
  Forestville         |Charlotteville |Norfolk          |G. W. Griffin
  Forfar              |Bastard        |Leeds, S. R.     |W. H. Young
  Fort Conlonge       |Mansfield      |Pontiac          |George Bryson
  Fort Erie           |Bertie         |Welland          |William Rainsford
  Fort William        |Esher          |Pontiac          |H. McKenzie
  Fox River (Sub)     |               |Gaspé            |J. D. St. Croix
  Frampton            |Frampton       |Dorchester       |John Ross
  Frankford           |Sidney         |Hastings, S. R.  |William Bowen
  Franktown           |Beckwith       |Lanark, S. R.    |E. McEwen
  Frankville          |Kitley         |Leeds and        |William Smith
                      |               |  Greenville,    |
                      |               |  N. R.          |
  Fredericksburg      |Fredericksburg |Lenox            |John Oliphant
  Freelton            |W. Flamboro’   |Wentworth, N. R. |Wm. N. Douglas
  Freiburg            |Waterloo, N.   |Waterloo, N. R.  |Ferdinand Romback
  Frelighsburg        |St. Armands    |Missisquoi       |Levi Kemp
  French Village      |Kingsey        |Drummond         |François Pothier
  Frost Village       |Shefford       |Shefford         |H. S. Foster
  Fullarton           |Fullarton      |Perth            |James Woodley
  Fulton              |Caistor        |Lincoln          |S. C. Greenman
                      |               |                 |
                      |               |                 |
  _Galt_              |Dumfries, N.   |Waterloo, S. R.  |John Davidson
  _Gananoque_         |Leeds          |Leeds, S. R.     |D. F. Britton
  Garafraxa           |Garafraxa      |Wellington, N. R.|George Skene
  Garthby             |Garthby        |Wolfe            |L. T. LeBel
  Gaspé Basin         |Gaspé          |Gaspé            |John Eden
  Gentilly            |Gentilly       |Nicolet          |Felix Brunelle
  _Georgetown_        |Esquesing      |Halton           |John Sumpter
  Georgeville         |Stanstead      |Stanstead        |C. S. Channell
  Georgina            |Georgina       |York, N. R.      |J. O. B. Bourchier
  Gilbert’s Mills     |Sophiasburg    |Prince Edward    |Daniel Gilbert
  Glanford            |Glanford       |Wentworth, S. R. |John Atkinson
  Glenelg             |Glenelg        |Grey             |Mark Appleby
  Glenloyd            |Inverness      |Megantic         |James Sturgeon
  Glenlyon            |Carrick        |Bruce            |J. Shannon
  Glen Morris         |Dumfries       |Brant            |Robert Sheil
  Glen William        |Esquesing      |Halton           |Charles Williams
  Goble’s Corners     |Blenheim       |Oxford, N. R.    |Wm. L. Goble
  _Goderich_          |Goderich       |Huron            |James Watson
  Golden Creek        |Bosanquet      |Lambton          |Allen Kennedy
  Goodwood            |Uxbridge       |Ontario, N. R.   |Michael Chapman
  Gore’s Landing      |Hamilton       |Northumberland,  |William Brown
                      |               |  W. R.          |
  Gormley’s Corners   |Markham        |York, E. R.      |James Gormley
  Gosfield            |Gosfield       |Essex            |Joseph Coatsworth
  Gosport             |Adolphustown   |Lenox            |Nicholas Bogart
  Gould               |Lingwick       |Compton          |James Ross
  Gower Point         |Westmeath      |Renfrew          |Gilbert Cannon
  Grahamsville        |Chinguacousy   |Peel             |George Graham
  _Granby_            |Granby         |Shefford         |Horace Lyman
  Grande Baie         |Bagot          |Chicoutimi       |Julien Saillant
  Grande Grève        |               |Gaspé            |Charles Esnouf
  Grande Ligne        |               |St. Johns        |James S. Gunning
  Grand River         |               |Gaspé            |Henry Dalton
  Greenbank           |Reach          |Ontario, N. R.   |Lawrence Van Allen
  Greenbush           |Elizabethtown  |Town of          |H. W. Blanchard
                      |               |  Brockville     |
  Greenock            |Greenock       |Bruce            |J. B. Ritchie
  Green Point         |Sophiasburg    |Prince Edward    |Philip Roblin
  Greensville         |West Flamboro’ |Wentworth, N. R. |James Joyce
  Greenwood           |Pickering      |Ontario, S. R.   |Wm. A. McCullough
  Grenville           |Grenville      |Argenteuil       |Edwin Pridham
  Grey                |Grey           |Huron            |William Tanner
  Griersville         |St. Vincent    |Grey             |Andrew Grier
  _Grimsby_           |Grimsby        |Lincoln          |R. F. Nelles
  Grondines           |Grondines      |Portneuf         |Jean Côté
  Grovesend           |Malahide       |Elgin, E. R.     |W. B. Lyon
  _Guelph_            |Guelph         |Wellington, S. R.|Robert Corbet
  Guysboro’           |Houghton       |Norfolk          |S. K. Garnham
                      |               |                 |
                      |               |                 |
  Hagersville         |Oneida         |Haldimand        |James G. Haskett
  _Haldimand_         |Haldimand      |Northumberland,  |John Taylor
                      |               |  W. R.          |
  Halifax             |Halifax        |Megantic         |André Bezeau
  Hall’s Mills        |Westminster    |Middlesex, E. R. |Charles Hall
  Ham                 |Ham            |Wolfe            |Israel Rice
  Hamburg             |Fredericksburgh|Lenox            |Richard Ham
  _Hamilton_          |Barton         |City of Hamilton |Edmund Ritchie
  Hampton             |Darlington     |Durham, W. R.    |H. Elliott
  Hannon              |Glanford       |Wentworth, S. R. |Joseph Hannon
  Hanover             |Bentinck       |Grey             |A. Z. Gottwalls
  Harlem              |Bastard        |Leeds, S. R.     |A. A. Chamberlain
  Harpurhey           |McKillop       |Huron            |M. MacDermid
  Harrietsville       |Dorchester     |Middlesex, E. R. |John McMillan
  Harrington, East    |Harrington     |Argenteuil       |A. Campbell
  Harrington, West    |W. Zorra       |Oxford, N. R.    |D. L. Demorest
  [3]Harrisburg       |Dumfries, South|Brant            |Samuel Stanton
  Harriston           |Minto          |Wellington, N. R.|J. Harrison
  Hartford            |Townsend       |Norfolk          |S. Dean
  Harwich             |Harwich        |Kent             |John McKinlay
  Harwood             |Hamilton       |Northumberland,  |James Barber
                      |               |  W. R.          |
  Hastings            |Asphodel       |Peterboro’       |Henry Fowlds
  _Hatley_            |Hatley         |Stanstead        |W. G. Cook
  _Hawkesbury_        |Hawkesbury     |Prescott         |Charles Hersey
  Hawkstone           |Oro            |Simcoe, N. R.    |C. Y. Bell
  Hawksville          |Wellesly       |Waterloo, N. R.  |Gabriel Hawk
  Hay                 |Hay            |Huron            |James Murray
  Haysville           |Wilmot         |Waterloo, S. R.  |John Hays
  Headford            |Markham        |York, E. R.      |Edward Taylor
  Headville           |Grantham       |Drummond         |Henry Menut
  Heck’s Corners      |South Gower    |Grenville, N. R. |J. S. Archibald
  Heidelburg          |Woolwich       |Waterloo, N. R.  |John Krassler
  Hemmingford         |Hemmingford    |Huntingdon       |John Scriver
  Henderson’s Corners |Emily          |Victoria         |R. Morton
  Henryville          |Sabrevois      |Iberville        |E. S. Goodenow
  Herdman’s Corners   |Hinchinbrooke  |Huntingdon       |M. S. McCoy
  Hereford            |Hereford       |Compton          |Aaron Workman
  Highland Creek      |Scarboro’      |York, E. R.      |W. Helliwell
  Hillier             |Hillier        |Prince Edward    |Philip Flagler
  Hillsboro’          |Plympton       |Lambton          |Thomas L. Hill
  Hillsburgh          |Erin           |Wellington, S. R.|William Gooderham
  Hilton              |Brighton       |Northumberland,  |Sylvester Richmond
                      |               |  E. R.          |
  Holland             |Holland        |Grey             |Wm. Lyons
  _Holland Landing_   |Gwillimbury,   |York, N. R.      |W. J. Sloane
                      |  East         |                 |
  Hollen              |Maryborough    |Wellington, N. R.|S. Robertson
  Holmesville         |Goderich       |Huron            |Wm. Holmes
  Holyrood            |Kinloss        |Bruce            |M. McKenzie
  Hopetown            |Lanark         |Lanark, N. R.    |Robert Cannon
  Hornby              |Esquesing      |Halton           |John McMillen
  Horning’s Mills     |Melancthon     |Grey             |James McGhee
  Houghton            |Houghton       |Norfolk          |
  Howick              |S. Georgetown  |Chateauguay      |Thomas Gebbie
  Hubbell’s Falls     |Fitzroy        |Carleton         |James Riddell
  Hull                |Hull           |Ottawa           |G. J. Marston
  Hullsville          |Walpole        |Haldimand        |John Hull
  Humber              |Etobicoke      |York, W. R.      |
  Humberstone         |Humberstone    |Welland          |John Thompson
  Hunterstown         |Hunterstown    |Maskinongé       |William Parker
  _Huntingdon_        |Godmanchester  |Huntingdon       |John Robinson
  Huntingville        |Ascot          |Richmond         |Caleb P. Mallory
  Huntley             |Huntley        |Carleton         |John Graham
  Huston              |Maryboro’      |Wellington, N. R.|Wm. Robinson
                      |               |                 |
                      |               |                 |
  _Indiana_           |Seneca         |Haldimand        |John Craigie
  Industry            |               |Joliette         |L. T. Groulx
  _Ingersoll_         |Oxford, N.     |Oxford, S. R.    |Charles E.
                      |               |                 |  Chadwick
  Inkermann           |Mountain       |Dundas           |John Renwick
  Innerkip            |E. Zorra       |Oxford, N. R.    |Robert Lindsay
  Innisfil            |Innisfil       |Simcoe, S. R.    |Benjamin Ross
  Innisville          |Drummond       |Lanark, S. R.    |Michael Murphy
  Inverhuron          |Bruce          |Bruce            |William Gunn
  Inverness           |Inverness      |Megantic         |Robert Layfield
  Iona                |Dunwich        |Elgin, W. R.     |William Harris
  Iron Hill           |Brome          |Brome            |Isaac Cutting
  Islay               |Fenelon        |Victoria         |D. Gilchrist
  Isle aux Coudres,   |               |Saguenay         |
    (sub-office)      |               |                 |
  Isle aux Grues      |               |L’Islet          |G. Lachance dit
                      |               |                 |  Jolicœur
  Isle aux Noix       |               |Iberville        |James Phillips
  Isle Perrot         |Isle Perrot    |Vaudreuil        |Marie S. Jobin
  Isle Verte          |Isle Verte     |Temiscouata      |Louis Bertrand
                      |               |                 |
                      |               |                 |
  Jarratt’s Corners   |Oro            |Simcoe, N. R.    |Charles Jarratt
  Jarvis              |Walpole        |Haldimand        |C. W. Shannon
  Jersey (Rivière     |               |Beauce           |
    Chaudière.)       |               |                 |
  Jerseyville         |Ancaster       |Wentworth, S. R. |H. F. Young
  Johnson             |Sydenham       |Grey             |Wm. Johnstone
  Johnson’s Corners   |Hemmingford    |Huntingdon       |Oliver Lyttle
  Johnson’s Mills     |Hay            |Huron            |Moses Johnson
  Johnville           |Eaton          |Compton          |Charles Smith
  Jordan              |Louth          |Lincoln          |Jacob Snure
                      |               |                 |
                      |               |                 |
  _Kamouraska_        |Kamouraska     |Kamouraska       |Alexis Gagné
  Kars                |N. Gower       |Carleton         |James Lindsay
  Katesville          |Adelaide       |Middlesex, W. R. |William McClatchey
  Keenansville        |Adjala         |Simcoe, S. R.    |P. D. Kelly
  Kelvin              |Burford        |Brant, W. R.     |John Kelly
  _Kemptville_        |Oxford         |Grenville, N. R. |W. H. Bottum
  Kennebec Line       |               |Dorchester       |David Fortin
  Kenyon              |Kenyon         |Glengary         |Donald Cattanach
  [4]Kertch           |Plympton       |Lambton          |James Oxenham
  Keswick             |N. Gwillimbury |York, N. R.      |David Sprague
  Kettleby Mills      |King           |York, N. R.      |Jacob Walton
  Kildare             |Kildare        |Joliette         |Jules Bourgeois
  Killarney           | North Shore of|Lake Huron       |R. Johnston
  Kilkenny            |Kilkenny       |Montcalm         |Nazaire Brien dit
                      |               |                 |  Durochers
  Kilmarnock          |Montague       |Lanark, S. R.    |
  Kilsyth             |Derby          |Grey             |Alexander Fleming
  Kilworth            |Delaware       |Middlesex, W. R. |John Brown
  Kinburn             |Fitzroy        |Carleton         |James Mills
  _Kincardine_        |Kincardine     |Bruce            |D. McKendrick
  King                |King           |York, N. R.      |Harvey J. Davis
  Kingsey             |Kingsey        |Drummond         |James W. Wilson
  Kingsey Falls       |Kingsey        |Drummond         |Hayes Gilman
  _Kingston_          |Kingston       |City of Kingston |Robert Deacon
  Kingston Mills      |Kingston       |Frontenac        |W. H. Deane
  Kingsville          |Gosfield       |Essex            |Alex. McDonald
  Kinloss             |Kinloss        |Bruce            |Thomas Hodgins
  Kinsale             |Pickering      |Ontario, S. R.   |John Fairless
  Kintail             |Asfield        |Huron            |D. McRae
  Kippen              |Tuckersmith    |Huron            |
  Kirkton             |Usborne        |Huron            |James Eaton
  Kirkwall            |Beverley       |Wentworth, N. R. |Malcolm Campbell
  Klineburg           |Vaughan        |York, W. R.      |H. S. Howland
  Knowlton            |Brome          |Brome            |Albert Kimball
  Knowlton Falls      |Brome          |Brome            |S. Richardson
  Komoka              |Lobo           |Middlesex, W. R. |O. D. Mabee
                      |               |                 |
                      |               |                 |
  La Baie             |La Baie        |Yamaska          |Joseph Rousseau
  La Beauce           |Ste. Marie     |Beauce           |George Louis
  L’Acadie            |L’Acadie       |St. Johns        |L. Archambeault
  _Lachine_           |Montreal       |Jacques Cartier  |James McElhearne
  _Lachute_           |Argenteuil     |Argenteuil       |John Meikle
  _Lacolle_           |Lacolle        |St. Johns        |T. Van Vliet
  Lafontaine          |Tiny           |Simcoe, N. R.    |Toussaint Moreau
  La Guerre           |Godmanchester  |Huntingdon       |John McDonald
  Lakefield           |Gore           |Argenteuil       |G. Rogers
  Lakeside            |E. Nissouri    |Oxford, N. R.    |H. McKenzie
  Lake Temiscouata    |               |Temiscouata      |George Dall
  L’Amaroux           |York           |York, W. R.      |James Taylor
  Lambton             |Lambton        |Beauce           |Dr. Louis
                      |               |                 |  Labrecque
  _Lanark_            |Lanark         |Lanark, N. R.    |A. G. Hall
  Lancaster           |Lancaster      |Glengary         |K. McPherson
  Lanoraie            |Lanoraie       |Berthier         |J. B. Galien
  Lansdown            |Lansdown       |Leeds, S. R.     |George McKelvey
  La Petite Rivière   |(Sub-office)   |Charlevoix       |
    St. François      |               |                 |
  La Pigeonnière      |LaSalle        |Napierville      |Moise Roy
  _Laprairie_         |Laprairie      |Laprairie        |John Charlton
  Largie              |Dunwich        |Elgin, W. R.     |
  L’Assomption        |St. Sulpice    |L’Assomption     |Joseph Guilbault
  Latta’s Mills       |Thurlow        |Hastings, S. R.  |George Ross
  Laval               |               |Montmorency      |Rev. T. N.
                      |               |                 |  Campbell
  Lavaltrie           |Lavaltrie      |Berthier         |N. L. Duplessis
  L’Avenir            |Durham         |Drummond         |H. S. Griffing
  Lawrenceville       |South Ely      |Shefford         |E. Lawrence
  Leamington          |Mersea         |Essex            |Warren Kimball
  Leavens             |St. Vincent    |Grey             |S. Cunningham
  _Leeds_             |Leeds          |Megantic         |Matthew Jiggins
  Lefroy              |Innisfil       |Simcoe, S. R.    |David Davidson
  Leith               |Sydenham       |Grey             |William Wylie
  Lemonville          |Whitchurch     |York, N. R.      |John Hill
  Lenox               |Fredericksburg |Lenox            |P. J. Forshee
  _Lennoxville_       |Ascot          |Town of Sherbr’ke|J. P. Cushing
  Les Eboulemens      |Eboulemens     |Charlevoix       |Charles Duberger
  Les Ecureuils       |D’Auteuil      |Portneuf         |P. Bedard
  Les Escoumains      |               |Saguenay         |Felix Têtu
  Leskard             |Clarke         |Durham, W. R.    |John McNeil
  Lifford             |Manvers        |Durham, E. R.    |George E. Shaw
  _Lindsay_           |Ops            |Victoria         |E. Culbert
  Lippincott          |York           |York, W. R.      |Thomas Larkin
  Lisadel             |Howick         |Huron            |Arthur Mitchell
  Lisbon              |N. Easthope    |Perth            |John Zinkann
  L’Islet             |L’Islet        |L’Islet          |D. S. Ballantyne
  Listowell           |Elma           |Perth            |W. H. Hacking
  Litchfield          |Litchfield     |Pontiac          |J. W. B. Ford
  Little Britain      |Mariposa       |Victoria         |Obadiah Rogers
  Little Rideau       |Hawkesbury     |Prescott         |Thomas Ross
  Lloydtown           |King           |York, N. R.      |Anthony Eastwood
  Lobo                |Lobo           |Middlesex, W. R. |H. Macklin
  Lochaber            |Lochaber       |Ottawa           |Richard Jones
  Lochiel             |Lochiel        |Glengary         |Owen Quigley
  _London_            |London         |Town of London   |Lawrence Lawless
  Long Island Locks   |Nepean         |Carleton         |George Rickey
  Long Point          |Island of      |Hochelaga        |J. B. Morin
                      |  Montreal     |                 |
  _Longueuil_         |Longueuil      |Chambly          |P. Lespérance
  Lonsdale            |Tyendinaga     |Hastings, S. R.  |Richard Wildman
  Lorette             |Lorette        |Quebec           |D. LeFrançois
  _L’Orignal_         |Alfred         |Prescott         |C. Johnson
  Lorraine            |Mono           |Simcoe, S. R.    |James Morrison
  Losky               |King           |York, N. R.      |Henry Baldwin
  Lotbinière          |Lotbinière     |Lotbinière       |Joseph Filteau
  Loughboro’          |Loughboro’     |Frontenac        |Hugh Madden
  Louisville          |Chatham        |Kent             |
  Low                 |Low            |Ottawa           |Caleb Brooks
  Lower Ireland       |Ireland        |Megantic         |
  Lowville            |Nelson         |Halton           |John McLaren
  _Lyn_               |Elizabethtown  |T’wn of          |N. Baxter
                      |               |  Brockville     |
  Lynden              |Beverley       |Wentworth, N. R. |John Howard
  Lyndhurst           |Lansdowne      |Leeds, S. R.     |William P. Lee
  Lynedoch            |Charlotteville |Norfolk          |George Grey
  Lyons               |S. Dorchester  |Elgin, E. R.     |William Secord
                      |               |                 |
                      |               |                 |
  McDonald’s Corners  |Dalhousie      |Lanark, N. R.    |Hugh McLean
  McGillivray         |McGillivray    |Huron            |D. Shoff
  Macville            |Albion         |Peel             |Robert H. Booth
  Madoc               |Madoc          |Hastings, N. R.  |A. F. Wood
  Mad River Mills     |Osprey         |Grey             |Andrew Yuill
  Magdalen Islands    |               |Gaspé            |J. J. Fox
  Magog               |Magog          |Stanstead        |Calvin Abbott
  Maidstone           |Maidstone      |Essex            |
  Maitland            |Augusta        |Grenville, S. R. |George C. Longley
  Malakoff            |Marlboro’      |Carleton         |W. J. Pierce
  Mallorytown         |Yonge          |Leeds, S. R.     |
  Malta               |Bruce          |Bruce            |W. Chisholm
  Manchester          |Reach          |Ontario, N. R.   |
  [5]Manilla          |Mariposa       |Victoria         |Mary Douglas
  Manitowaning        |        On Lake|Huron            |George Ironside
  Manningville        |               |Huntingdon       |Fisher Ames
  Manvers             |Manvers        |Durham, E. R.    |H. Staples
  Maple               |Vaughan        |York, W. R.      |Joseph Noble
  Maple Grove         |Ireland        |Megantic         |Thomas Barwis
  Mapleton            |Yarmouth       |Elgin, E. R.     |Benjamin Wilson
  Mara                |Mara           |Ontario, N. R.   |William Ritchie
  Marbleton           |Dudswell       |Wolfe            |J. B. Bishop
  March               |March          |Carleton         |Thomas Reid
  _Markham_           |Markham        |York, E. R.      |Archibald Barker
  Marlow              |               |Beauce           |James Armstrong
  Marmora             |Marmora        |Hastings, N. R.  |D. G. Bowen
  Marshville          |Wainfleet      |Welland          |Edward Lee
  Martintown          |Charlottenburg |Glengary         |Robert Blackwood
  Martinville         |Clifton        |Compton          |Amasa Martin
  Marysville          |Tyendinaga     |Hastings, S. R.  |
  Mascouche           |Mascouche      |L’Assomption     |Philip Mount
  Maskinongé          |Maskinongé     |Maskinongé       |A. T. Lafrenière
  Massawippi          |West Hatley    |Stanstead        |Luther Abbott
  Matane              |Matane         |Rimouski         |L. N. Blais
  Matilda             |Matilda        |Dundas           |George Brouse
  Mayfield            |Chinguacousy   |Peel             |William Spiers
  Mayne               |Wallace        |Perth            |James Bolton
  Medonte             |Medonte        |Simcoe, N. R.    |Edmund Moon
  Melancthon          |Melancthon     |Grey             |James Brown
  _Melbourne_         |Melbourne      |Richmond         |Thomas Tait
  Melrose             |Tyendinaga     |Hastings, S. R.  |George Duncan
  Melville            |Hillier        |Prince Edward    |John Wilson
  _Merrickville_      |Wolford        |Grenville, N. R. |E. H. Whitmarsh
  Merritsville        |Crowland       |Welland          |Thomas Burgar
  Mersea              |Mersea         |Essex            |Jonathan Wigfield
  Merton              |Nelson         |Halton           |Henry Harrison
  Metis               |Metis          |Rimouski         |W. E. Page
  Meyersburg          |Seymour        |Northumberland,  |Charles Lavis
                      |               |  E. R.          |
  Middleville         |Lanark         |Lanark, N. R.    |James Guthrie
  Milford             |Marysburgh     |Prince Edward    |Thomas Cook
  Milbank             |Mornington     |Perth            |W. Rutherford
  Mill Brook          |Cavan          |Durham, E. R.    |Mrs. Matthew
                      |               |                 |  Knowlton
  Mille Vaches        |               |Saguenay         |John Peverley
  Mill Grove          |West Flamboro’ |Wentworth, N. R. |A. B. Palmer
  Mill Haven          |Ernestown      |Addington        |Jeremiah Amey
  Mill Point          |Richmond       |Lenox            |James Bowen
  Milnesville         |Markham        |York, E. R.      |Peter Milne
  Milton, East        |Milton         |Shefford         |Charles Gillespie
  _Milton, West_      |Trafalgar      |Halton           |William D. Lyon
  _Mitchell_          |Logan          |Perth            |John Hicks
  Mohawk              |Brantford, W.  |Brant, W. R.     |Wm. L. Jones
  Moira               |Huntingdon     |Hastings, N. R.  |Henry Ostrom
  Molesworth          |Grey           |Huron            |John Mitchell
  Mono Centre         |Mono           |Simcoe, S. R.    |Robert Laidlaw
  Mono Mills          |Mono           |Simcoe, S. R.    |John McLaughlin
  Montcalm            |Rawdon         |Montcalm         |J. B. LeBlanc
  Monte-Bello         |Petite Nation  |Ottawa           |Charles Major, Jr.
  _Montreal_          |Montreal       |City of Montreal |Dr. J. B. Meilleur
  Montrose            |Stamford       |Welland          |Archibald Thompson
  Mont St. Hilaire    |St. Hilaire    |Rouville         |H. W. Hitchcock
  Moore               |Moore          |Lambton          |Wm. MacPherson
  Morgantown          |Erin           |Wellington, S. R.|Wm. M. Crewson
  Morningdale Mills   |Mornington     |Perth            |J. Nicklin
  _Morpeth_           |Howard         |Kent             |D. Warren
  Morrisbank          |Morris         |Huron            |C. B. Hamilton
  _Morrisburg_        |Matilda        |Dundas           |James Holden
  Morrisdale          |Grey           |Huron            |Donald Scott
  Morriston           |Puslinch       |Wellington, S. R.|R. B. Morrison
  Morton              |S. Crosby      |Leeds, S. R.     |George Morton
  Morven              |Ernestown      |Addington        |James P. Lake
  Moscow              |Camden, E.     |Addington        |Zarra Vanluven
  Moulinette          |Cornwall       |Town of Cornwall |S. H. Moss
  Mountain            |Mountain       |Dundas           |James Cleland
  Mount Albion        |Barton         |Wentworth, S. R. |William Cook
  Mount Brydges       |Carradoc       |Middlesex, W. R. |E. Mihell, Jr.
  Mount Elgin         |Dereham        |Oxford, S. R.    |J. S. Woodward
  Mount Forest        |Arthur         |Wellington, N. R.|F. McDonald
  Mount Johnson       |Monoir         |Rouville         |John McQuillen
  Mount Pleasant      |Cavan          |Durham, E. R.    |S. J. Best
  Mount St. Patrick   |Brougham       |Renfrew          |Thomas Brady
  Mount Vernon        |Brantford, W.  |Brant, W. R.     |Thomas Perrin
  Mulmur              |Mulmur         |Simcoe, S. R.    |John Little
  Munsel              |Wolford        |Grenville, N. R. |James Bryant
  Murray              |Murray         |Northumberland,  |Reuben Young
                      |               |  E. R.          |
  Murray Bay          |Mountmurray    |Charlevoix       |Cléophe Cimon
  Murvale             |Portland       |Frontenac        |Michael Davy
                      |               |                 |
                      |               |                 |
  Nanticoke           |Walpole        |Haldimand        |Samuel Hasket
  _Napanee_           |Richmond       |Lenox            |Alex. Campbell
  Napier              |Metcalfe       |Middlesex, W. R. |John Munroe
  _Napierville_       |DeLery         |Napierville      |Loop Odell
  Nassagiweya         |Nassagiweya    |Halton           |Thomas
                      |               |                 |  Easterbrooke
  Nelson              |Nelson         |Halton           |A. G. MacCay
  New Aberdeen        |Waterloo, S.   |Waterloo, S. R.  |George Davidson
  Newark              |Norwich        |Oxford, S. R.    |Augustus Gary
  _Newboro’_          |N. Crosby      |Leeds, S. R.     |J. B. Stevens
  _Newburg_           |Camden, East   |Addington        |A. F. G. Hooper
  Newbury             |Mosa           |Middlesex, W. R. |Robert Thompson
  New Carlisle        |Cox            |Bonaventure      |Matthew Caldwell
  _New Castle_        |Clarke         |Durham, W. R.    |Hiram Hodges
  New Dundee          |Wilmot         |Waterloo, S. R.  |F. G. Miller
  New Durham          |Burford        |Brant, W. R.     |E. F. Schooley
  New Glasgow         |Lacorne        |Terrebonne       |William Furse
  New Hamburg         |Wilmot         |Waterloo, S. R.  |William Scott
  New Hope            |Waterloo, N.   |Waterloo, N. R.  |Conrad Nahrgang
  New Ireland         |Ireland        |Megantic         |Richard C. Porter
  Newland             |E. Gwillimbury |York, N. R.      |R. Hunter
  New Liverpool       |Lauzon         |Levi             |John McKenzie
  _New Market_        |Whitchurch     |York, N. R.      |William Roe
  Newport             |Brantford      |Brant, W. R.     |Thaddeus Smith
  New Richmond        |New Richmond   |Bonaventure      |Richard Brash
  New Sarum           |Yarmouth       |Elgin, E. R.     |Job Gibson
  Newtown Robinson    |Tecumseth      |Simcoe, S. R.    |Wm. Chantler
  _Niagara_           |Niagara        |Town of Niagara  |Robert Conner
  _Nicolet_           |Nicolet        |Nicolet          |H. A. Chillas
  Nilestown           |Dorchester, N. |Middlesex, E. R. |Joshua Putnam
  Nissouri            |Nissouri, West |Middlesex, E. R. |N. P. Allen
  Nithburg            |N. Easthope    |Perth            |James Brown
  Nobleton            |King           |York, N. R.      |Thomas Noble
  Normanby            |Normanby       |Grey             |Thomas Caldwell
  Normandale          |Charlotteville |Norfolk          |John W. Sheppard
  Normanton           |Saugeen        |Bruce            |John J. Lehnen
  North Adjala        |Adjala         |Simcoe, S. R.    |Wm. Donehey
  North Arthur        |Arthur         |Wellington, N. R.|
  North Augusta       |Augusta        |Grenville, S. R. |Samuel J. Bellamy
  North Douro         |Douro          |Peterboro’       |Robert Casement
  North Eldon         |Eldon          |Victoria         |Wm. MacCreadie
  North Ely           |Ely            |Shefford         |G. Bartlett
  North Georgetown    |Beauharnois    |Chateauguay      |Basile Vannier
  North Glanford      |Glanford       |Wentworth, S. R. |Jacob Terryberry
  North Gower         |N. Gower       |Carleton         |Horatio Holden
  North Lancaster     |Lancaster      |Glengary         |Charles Leclair
  North Pelham        |Pelham         |Welland          |Adam McGlashan
  North Port          |Sophiasburg    |Prince Edward    |Samuel Solmes
  North Stanbridge    |Stanbridge     |Missisquoi       |William Clarke
  North Stukeley      |Stukeley       |Shefford         |M. A. Bessette
  North Sutton        |Sutton         |Brome            |Horace P. Sweet
  North Walsingham    |Walsingham     |Norfolk          |John Newlove
  North Williamsburg  |Williamsburg   |Dundas           |Walter Bell
  Norton Creek        |Beauharnois    |Chateauguay      |Thomas Cantwell
  Norval              |Esquesing      |Halton           |William Clay
  _Norwich_           |Norwich        |Oxford, S. R.    |Gilbert Moore
  Norwood             |Asphodel       |Peterboro’       |James Foley
  Nottawa (Sub)       |Nottawasaga    |Simcoe, N. R.    |William Rowland
  Nottawasaga         |Nottawasaga    |Simcoe, N. R.    |Francis Hewson
  Nottawasaga Station |Nottawasaga    |Simcoe, N. R.    |D. Baine
  Notre Dame du       |               |Temiscouata      |Benjamin Michaud
    Portage           |               |                 |
                      |               |                 |
                      |               |                 |
  Oakland             |Oakland        |Brant, W. R.     |John Toyne
  Oak Ridges          |Whitchurch     |York, N. R.      |A. McKechanie
  _Oakville_          |Trafalgar      |Halton           |R. Balmer
  Oakwood             |Mariposa       |Victoria         |A. A. McLauchlin
  [6]Oban             |Plympton       |Lambton          |Peter McGregor
  Odessa              |Ernestown      |Addington        |P. S. Timmerman
  Omagh               |Trafalgar      |Halton           |William C. Beaty
  Oneida              |Oneida         |Haldimand        |J. T. Mutchmore
  Onondaga            |Tuscarora      |Brant, W. R.     |Wm. S. Buckwell
  Onslow              |Onslow         |Pontiac          |Walton Smith
  Ontario             |Saltfleet      |Wentworth, S. R. |John Wilson
  _Orangeville_       |Garafraxa      |Wellington, N. R.|Orange Lawrence
  Orchill             |Morris         |Huron            |J. B. Taylor
  _Orillia_           |Orillia        |Simcoe, N. R.    |E. G. Slee
  Ormstown            |Beauharnois    |Chateauguay      |William Cross
  Oro                 |Oro            |Simcoe, N. R.    |Donald Grant
  Orono               |Clarke         |Durham, W. R.    |Joseph L. Tucker
  [7]Orwell           |Yarmouth       |Elgin, E. R.     |D. Sutherland
  Osgoode             |Osgoode        |Carleton         |Adam J. Baker
  _Oshawa_            |Whitby         |Ontario, S. R.   |Gavin Burns
  Osprey              |Osprey         |Grey             |James Gibson
  Ospringe            |Erin           |Wellington, S. R.|Francis Clark
  _Otanabee_          |Otanabee       |Peterboro’       |Thomas Short
  _Ottawa City_       |Gloucester     |City of Ottawa   |G. W. Baker
  Ottawa Glass Works  |Vaudreuil      |Vaudreuil        |John Hodgson
  Otterville          |Norwich        |Oxford, S. R.    |John H. Cornell
  Ouiseau             |Sheen          |Pontiac          |John Andrews
  Oungah              |Chatham        |Kent             |Stephen Kinny
  _Owen Sound_        |Sydenham       |Grey             |George Brown
  Oxford Centre       |Oxford         |Oxford, S. R.    |James F. Chapman
  Oxford Mills        |Oxford         |Grenville, N. R. |Richey Waugh
  Oznabruck Centre    |Oznabruck      |Stormont         |Jacob Poaps
                      |               |                 |
                      |               |                 |
  Paisley             |Elderslie      |Bruce            |Thomas Orchard
  _Pakenham_          |Pakenham       |Lanark, N. R.    |William Dickson
  _Palermo_           |Trafalgar      |Halton           |H. M. Switzer
  Papineauville       |Petite Nation  |Ottawa           |Stephen Tucker
  _Paris_             |Dumfries, S.   |Brant, E. R.     |George Macartney
  Paspebiac           |               |Bonaventure      |Daniel Bisson
  Pefferlaw           |Georgina       |York, N. R.      |J. Johnson
  Pelham Union        |Pelham         |Welland          |J. C. Buckbee
  _Pembroke_          |Pembroke       |Renfrew          |Alexander Moffatt
  _Penetanguishene_   |Tiny           |Simcoe, N. R.    |D. J. Mitchell
  Penville            |Tecumseth      |Simcoe, S. R.    |Henry Stone
  Percé               |Percé          |Gaspé            |J. E. Tuzo
  Percy               |Percy          |Northumberland,  |Dr. B. G. G.
                      |               |  E. R.          |  Demorest
  Perrytown           |Hope           |Durham, E. R.    |A. Choate
  _Perth_             |Drummond       |Lanark, S. R.    |J. P. Grant
  _Peterboro’_        |N. Monaghan    |Peterboro’       |S. J. Carver
  Petersburg          |Wilmot         |Waterloo, S. R.  |John Ernst
  _Philipsburg (East)_|St. Armand     |Missisquoi, W. R.|D. T. R. Nye
  Philipsburg (West)  |Wilmot         |Waterloo, S. R.  |G. C. Doering
  Philipsville        |Bastard        |Leeds, S. R.     |Sidney A. Taplin
  _Pickering_         |Pickering      |Ontario, S. R.   |P. F. Whitney
  _Picton_            |Marysburgh     |Prince Edward    |David Barker
  Pierreville         |Pierreville    |Yamaska          |Henry Vassal
  Pigeon Hill         |St. Armand     |Missisquoi, W. R.|S. W. Stone
  _Pike River_        |Stanbridge     |Missisquoi, W. R.|A. L. Taylor
  Pine Orchard        |Whitchurch     |York, N. R.      |Moses Willson
  Pine River          |Huron          |Bruce            |J. W. Gamble
  Pittsferry          |Pittsburg      |Frontenac        |Daniel Root
  Plantagenet         |Plantagenet    |Prescott         |Peter McMartin
  Plattsville         |Blenheim       |Oxford, N. R.    |Samuel Platt
  Point Abino         |Bertie         |Welland          |Ralph Disher
  Point Alexander     |Rolph          |Renfrew          |Benjamin McConnel
  Pointe au Chêne     |Grenville      |Argenteuil       |Archibald Cameron
  Pointe aux Anglais  |Two Mountains  |Two Mountains    |Bazile Charlebois
  Pointe aux Trembles |Island of      |Hochelaga        |P. Dubreuil
                      |  Montreal     |                 |
  Pointe aux Trembles |Pointe aux     |Portneuf         |François X. Larue
                      |  Trembles     |                 |
  Pointe Claire       |Montreal       |Jacques Cartier  |P. C. Valois
  Pointe du Lac       |Pointe du Lac  |St. Maurice      |Léon Décoteau
  Point Fortune       |Rigaud         |Vaudreuil        |A. St. Denis
  Point Levi          |Lauzon         |Levi             |Robert Buchanan
  Point Levi East     |Lauzon         |Levi             |Honoré Montminy
  Point Platon        |St. Croix      |Lotbinière       |Stanislas Hamel
  Point St. Peter     |Malbaie        |Gaspé            |George Packwood
  Pontiac Mills       |Onslow         |Pontiac          |D. Rattray
  Portage du Fort     |Litchfield     |Pontiac          |D. F. McLaren
  Port Albert         |Ashfield       |Huron            |Thomas Hawkins
  Port au Persil      |Mount Murray   |Charlevoix       |John McLaren
  Port Bruce          |Malahide       |Elgin, E. R.     |Charles Fraser
  Port Burwell        |Bayham         |Elgin, E. R.     |Thomas Pilcher
  _Port Colborne_     |Humberstone    |Welland          |J. Manly
  Port Credit         |Etobicoke      |York, W. R.      |James Cotton
  _Port Dalhousie_    |Grantham       |Lincoln          |John H. Martindale
  Port Daniel         |Port Daniel    |Bonaventure      |Patrick Sweetman
  _Port Dover_        |Woodhouse      |Norfolk          |Walker Powell
  Port Elmsley        |N. Elmsley     |Lanark, S. R.    |Robert Garry
  Port Hoover         |Cartwright     |Durham, W. R.    |Thomas Hoover
  _Port Hope_         |Hope           |Durham, E. R.    |David Smart
  Portland            |Bastard        |Leeds, S. R.     |S. S. Scovil
  Port Maitland       |Sherbrooke     |Haldimand        |William Benson
  Port Milford        |Marysburgh     |Prince Edward    |Henry Vandusen
  Port Nelson         |Nelson         |Halton           |Hugh Cotter
  Portneuf            |Portneuf       |Portneuf         |Siméon Larue
  Port Perry          |Reach          |Ontario, N. R.   |Joseph Bigelow
  _Port Robinson_     |Thorold        |Welland          |Andrew Murray
  _Port Rowan_        |Walsingham     |Norfolk          |Andrew McLennan
  Port Royal          |Walsingham     |Norfolk          |Elisha Bingham
  Port Ryerse         |Woodhouse      |Norfolk          |Wm. H. Ryerse
  Portsmouth          |Kingston       |Frontenac        |George McLeod
  Port St. Francis    |Nicolet        |Nicolet          |J. C. Simmons
  _Port Sarnia_       |Sarnia         |Lambton          |David McCall
  _Port Stanley_      |Yarmouth       |Elgin, E. R.     |J. Henderson
  Port Talbot         |Dunwich        |Elgin, W. R.     |John Clark
  _Prescott_          |Augusta        |Grenville, S. R. |Alpheus Jones
  _Preston_           |Waterloo, S.   |Waterloo, S. R.  |Jacob Hespeler
  Priceville          |Artemesia      |Grey             |Wm. Ferguson
  Princeton           |Blenheim       |Oxford, N. R.    |Alex. Milmine
  Prospect            |Beckwith       |Lanark, S. R.    |Wm. Williams
  Proton              |Proton         |Grey             |George Armstrong
  Puslinch            |Puslinch       |Wellington, S. R.|William Leslie
                      |               |                 |
                      |               |                 |
  _Quebec_            |Quebec         |Quebec           |John Sewell
  Queensborough       |Elzevir        |Hastings, N. R.  |Simon McKenzie
  Queenston           |Niagara        |Welland          |Joseph Wynn
  Queensville         |E. Gwillimbury |York, N. R.      |James Aylward
                      |               |                 |
                      |               |                 |
  Raglan              |Whitby         |Ontario, S. R.   |Philip Ranons
  Railton             |Loughboro’     |Frontenac        |John Walsh
  Rainham             |Rainham        |Haldimand        |Charles Williams
  Rainham Centre      |Rainham        |Haldimand        |William Jones
  _Ramsay_            |Ramsay         |Lanark, N. R.    |James Wylie, Jr.
  Rapides des Joachims|Aberdeen       |Pontiac          |Tiberius Colton
  Ratho               |Blandford      |Oxford, N. R.    |Walter S. Elliott
  Ravenswood          |Bosanquet      |Lambton          |John Rawlings
  Rawdon              |Rawdon         |Montcalm         |Luke Daly
  Reach               |Reach          |Ontario, N. R.   |Abner Hurd
  Reading             |Garafraxa      |Wellington, N. R.|James Donaldson
  Rednersville        |Ameliasburgh   |Prince Edward    |James Redner
  _Renfrew_           |Horton         |Renfrew          |George Ross
  Repentigny          |L’Assomption   |L’Assomption     |Benjamin Moreau
  Riceville           |Plantagenet    |Prescott         |Peter McLauren
  Richmond, (East)    |Shipton        |Richmond         |G. K. Foster
  Richmond, (West)    |Goulbourn      |Carleton         |Mrs. W. R. R. Lyon
  _Richmond Hill_     |Vaughan        |York, W. R.      |Matthew Teefy
  Richview            |Toronto Gore   |Peel             |John Davis
  Richwood            |Blenheim       |Oxford, N. R.    |John Pine
  Ridgetown           |Howard         |Kent             |T. Rushton
  _Rigaud_            |Rigaud         |Vaudreuil        |A. W. Charlebois
  _Rimouski_          |Rimouski       |Rimouski         |P. Gauvreau
  River David         |               |Yamaska          |Benjamin Thérien
  River Desert        |               |Ottawa           |J. G. Williams
  River St. Louis     |St. Louis      |Beauharnois      |Peter St. Denis
  Riversdale          |Greenock       |Bruce            |George Cromar
  Rivière aux Canards |               |Charlevoix       |J. Radford
  Rivière des Prairies|Montreal       |Hochelaga        |G. Robillard
  _Rivière du Loup,   |Rivière du Loup|Temiscouata      |Charles H. Gaudry
    (en bas.)_        |               |                 |
  Rivière du Loup,    |Rivière du Loup|Maskinongé       |Louis Baribeau
    (en haut.)        |               |                 |
  Rivière Ouelle      |Rivière Ouelle |Kamouraska       |Charles H. Têtu,
                      |               |                 |  Sr.
  Rivière Trois       |Trois Pistoles |Temiscouata      |Nazaire Têtu
    Pistoles          |               |                 |
  Robinson            |Bury           |Compton          |Lemuel Pope
  Roblin              |Richmond       |Lenox            |Ezra A. Spencer
  Rochester           |Rochester      |Essex            |Moise Ouellette
  Rockford            |Townsend       |Norfolk          |John Fessender
  Rockton             |Beverley       |Wentworth, N. R. |W. W. Barlow
  Rockwood            |Eramosa        |Wellington, S. R.|Robert Pasmore
  Rolph               |Middleton      |Norfolk          |E. D. Buchner
  Romney              |Romney         |Kent             |Thomas Renwick
  Rond’eau            |Harwich        |Kent             |
  Rosebank            |Brantford      |Brant, E. R.     |John Thomas
  Rosetta             |Lanark         |Lanark, N. R.    |John Dods
  Roseville           |Dumfries, N.   |Waterloo, S. R.  |J. R. Detwiler
  Roslin              |Thurlow        |Hastings, S. R.  |George Mowatt
  Ross                |Ross           |Renfrew          |James McLaren
  Rothsay             |Maryboro’      |Wellington, N. R.|William West
  Rouge Hill          |Pickering      |Ontario, S. R.   |Emanuel Playter
  Rougemont           |St. Césaire    |Rouville         |D. Bachelder
  Rowan Mills         |Walsingham     |Norfolk          |H. DeBlaquière
  Roxborough          |Roxborough     |Stormont         |D. McCallum
  Roxton Falls        |Roxton         |Shefford         |Benjamin Savage
  Russell             |Russell        |Russell          |Richard Helmer
  Russeltown          |               |Chateauguay      |Lorenzo Hogle
  Ryckman’s Corners   |Glanford       |Wentworth, S. R. |G. M. Ryckman
                      |               |                 |
                      |               |                 |
  Ste. Adèle          |Abercrombie    |Terrebonne       |J. B. Villemure
  St. Agatha          |Wilmot         |Waterloo, S. R.  |Anthony Kaiser
  St. Aimé            |               |Richelieu        |P. Gélinas
  St. Alexandre       |               |Kamouraska       |Edmond Levéque
  St. Alexandre       |               |Iberville        |P. H. Dulcide
  St. Alexis          |St. Sulpice    |Montcalm         |J. D. Racette
  St. Alphonse        |               |Joliette         |Luke Corcoran
  St. André           |St. André      |Kamouraska       |P. C. Marquis
  St. André Avelin    |Petite Nation  |Ottawa           |A. T. Gibeau
  _St. Andrews (East)_|Argenteuil     |Argenteuil       |Thomas Meikle
  St. Andrews (West)  |Cornwall       |Town of Cornwall |Allan Grant
  Ste. Angélique      |Petite Nation  |Ottawa           |J. B. N. Papineau
  St. Anicet          |Godmanchester  |Huntingdon       |F. S. Bourgeault
  Ste. Anne, Bout de  |Montreal       |Jacques Cartier  |Edward McNaughton
     l’Isle           |               |                 |
  Ste. Anne de la     |Ste. Anne      |Champlain        |Thélesphore Méthot
    Pérade            |               |                 |
  Ste. Anne des Monts |               |Gaspé            |J. Perrée
  Ste. Anne des       |Ste. Anne      |Terrebonne       |Hector Granger
    Plaines           |               |                 |
  Ste. Anne la        |Ste. Anne      |Kamouraska       |Joseph Dionne
    Pocatière         |               |                 |
  St. Anns, Lincoln   |Gainsboro’     |Lincoln          |Jacob Upper
  St. Anselme         |St. Anselme    |Dorchester       |F. F. Buteau
  St. Antoine,        |St. Antoine    |Lotbinière       |Edmond Larue
    Lotbinière        |               |                 |
  St. Antoine, River  |               |Verchères        |Narcisse Cartier
    Richelieu         |               |                 |
  St. Armand Centre   |St. Armand     |Missisquoi, W. R.|Mrs. J. Potter
  St. Arsène          |Cacouna        |Temiscouata      |Elzéar Pelletier
  St. Athanase        |St. Athanase   |Iberville        |V. Vincelette
  St. Augustin,       |               |Portneuf         |C. East
    Portneuf          |               |                 |
  St. Augustin, Two   |               |Two Mountains    |J. N. Mignault
    Mountains         |               |                 |
  St. Barnabé, St.    |St. Barnabé    |St. Maurice      |L. Bellemare
    Maurice           |               |                 |
  St. Barnabé, River  |St. Barnabé    |St. Hyacinthe    |Edouard Mathieu
    Yamaska           |               |                 |
  St. Barthélemi      |St. Barthélemi |Berthier         |J. Fauteux
  St. Bazile, (sub    |St. Bazile     |Portneuf         |
    office.)          |               |                 |
  St. Bénoit          |Two Mountains  |Two Mountains    |A. L. Brien
  St. Bernard         |St. Bernard    |Dorchester       |Pierre Plante
  Ste. Brigide        |Monoir         |Iberville        |William Murray
  St. Bruno           |Montarville    |Chambly          |A. P. Paré
  St. Casimir         |St. Casimir    |Portneuf         |Nar. Parré
  St. Catherines      |Fossambault    |Portneuf         |Joseph Maloney
    (East.)           |               |                 |
  _St. Catherines     |Grantham       |Lincoln          |J. P. Merritt
    (West.)_          |               |                 |
  St. Célestin        |               |Nicolet          |C. E. Houde
  St. Césaire         |               |Rouville         |C. Dorval
  St. Charles (River  |St. Charles    |St. Hyacinthe    |J. E. LeBlanc
    Richelieu.)       |               |                 |
  St. Charles (River  |Bellechasse    |Bellechasse      |J. Montminy
    Boyer.)           |               |                 |
  St. Christophe      |Arthabaska     |Arthabaska       |A. Stein
    (d’Arthabaska.)   |               |                 |
  Ste. Claire         |Ste. Claire    |Dorchester       |L. V. Royer
  St. Clements        |Wellesley      |Waterloo, N. R.  |John Stroh
  St. Clet            |Vaudreuil      |Vaudreuil        |J. H. Thisdale
  St. Columbin        |               |Two Mountains    |M. J. Phelan
  St. Constant        |Laprairie      |Laprairie        |M. Norbert
  Ste. Croix          |Ste. Croix     |Lotbinière       |Moïse Couture
  St. Cuthbert        |               |Berthier         |J. Chenevert
  Ste. Cyrille        |               |L’Islet          |J. B. Cloutier
  St. Damase          |St. Damase     |St. Hyacinthe    |F. Brin
  St. Davids          |Niagara        |Lincoln          |C. Fisher
  St. Denis (River    |St. Denis      |St. Hyacinthe    |F. X. Laforce
    Richelieu.)       |               |                 |
  St. Denis (de la    |               |Kamouraska       |J. D. Lavoie
    Bouteillerie.)    |               |                 |
  St. Didace          |Lanaudière     |Maskinongé       |C. F. Turgeon
  St. Dominique       |               |Bagot            |François X. Dupont
  St. Edouard         |               |Napierville      |J. Blain
  Ste. Elizabeth      |               |Joliette         |P. L. Hudon dit
                      |               |                 |  Beaulieu
  St. Eloi            |               |Temiscouata      |B. Langlois
  St. Elzéar          |               |Beauce           |Joseph Rény
  St. Esprit          |               |Montcalm         |B. Vézina
  St. Etienne         |St. Maurice    |St. Maurice      |O. Desilets
  _St. Eustache_      |               |Two Mountains    |David Mitchell
  St. Fabien          |               |Rimouski         |Vital Roy dit
                      |               |                 |  Lauzon
  Ste. Famille        |Island of      |Montmorency      |J. Letourneau
                      |  Orleans      |                 |
  St. Félix de Valois |               |Joliette         |Max. Crépeau
  St. Féréol, (sub    |               |Montmorency      |
    office.)          |               |                 |
  Ste. Flavie         |               |Rimouski         |J. B. LaMontague
  St. Foy             |Quebec         |Quebec           |Joseph Roy
  St. Francis         |               |Yamaska          |O. H. Coutu
  St. François        |               |Montmagny        |J. B. Langlois
    (Montmagny.)      |               |                 |
  St. François        |Beauce         |Beauce           |F. X. Ponsant
    (Beauce.)         |               |                 |
  St. François        |Island of      |Montmorency      |C. E. Dagneault
    (d’Orléans.)      |  Orleans      |                 |  dit Laprise
  St. Gabriel (de     |Brandon        |Berthier         |O. Chalut
    Brandon.)         |               |                 |
  Ste. Généviève      |Montreal       |Jacques Cartier  |J. M. Paquin
  St. George (Beauce.)|St. George     |Beauce           |William Webb
  _St. George         |Dumfries, S.   |Brant, E. R.     |George Stanton
    (Brant.)_         |               |                 |
  St. George          |Huntingdon     |Hastings, N. R.  |John Francis
    (Hastings.)       |               |                 |
  Ste. Gertrude       |Ste. Gertrude  |Nicolet          |Léon Champoux
  St. Gervais         |St. Gervais    |Bellechasse      |Joseph Jolivet
  St. Giles           |St. Giles      |Lotbinière       |George Côté
  St. Grégoire        |St. Grégoire   |Nicolet          |Stanislas Doucet
  Ste. Hélène         |               |Kamouraska       |N. Peltier
  St Hélène de Bagot  |               |Bagot            |Ulric Vaillant
  St. Helens          |Wawanosh       |Huron            |John Mackay
  St. Hénedine        |               |Dorchester       |Marcel Fortier
  St. Henri           |Lauzon         |Levi             |E. H. Marçeau
  St. Hermas          |               |Two Mountains    |D. Marsil
  St. Hilaire         |St. Hilaire    |Rouville         |Thomas Valiquet
  St. Hugues          |               |Bagot            |Charles Blain
  _Ste. Hyacinthe_    |St. Hyacinthe  |St. Hyacinthe    |E. L. R. C.
                      |               |                 |  Després
  St. Irenée          |               |Charlevoix       |Joseph Gosselin
  St. Isidore         |               |Dorchester       |B. Morin
    (Dorchester.)     |               |                 |
  St. Isidore         |               |Laprairie        |F. L. Langevin
    (Laprairie.)      |               |                 |
  St. Jacobs          |Woolwich       |Waterloo, N. R.  |Joseph Eby
  St. Jacques         |St. Sulpice    |L’Assomption     |J. E. Ecrement
  St. Jacques le      |               |Laprairie        |Joseph O. Poirier
    Mineur            |               |                 |
  St. Janvier         |DeBlainville   |Terrebonne       |
  St. Jean Baptiste   |Rouville       |Rouville         |L. D. Gareaud
  St. Jean Chrysostôme|               |Chateauguay      |J. A. Leriche
    (Chateauguay.)    |               |                 |
  St. Jean Chrysostôme|Lauzon         |Levi             |J. Giroux
    (Levi.)           |               |                 |
  St. Jean des        |               |Lotbinière       |P. C. Le Vasseur
    Chaillons         |               |                 |
  St. Jean d’Orleans  |Island of      |Montmorency      |F. X. Turcotte
                      |  Orleans      |                 |
  St. Jean Port Joli  |St. Jean Port  |L’Islet          |F. Fournier
                      |  Joli         |                 |
  St. Jerôme          |               |Terrebonne       |Louis G. Loranger
  _St. Johns (East)_  |               |St. Johns        |W. A. Osgood
  St. Johns (West)    |Pelham         |Welland          |John Wilkerson
  St. Joseph          |St. Joseph     |Beauce           |Joseph O. C.
                      |               |                 |  Arcand
  St. Joseph du Lac   |Two Mountains  |Two Mountains    |John McCoul
  St. Jude            |               |St. Hyacinthe    |N. Gauthier
  Ste. Julie          |Belœil         |Verchères        |E. Chagnon
  Ste. Julienne       |               |Montcalm         |T. Perrault
  St. Lambert         |Lauzon         |Levi             |M. Brochu
  St. Laurent         |Island of      |Montmorency      |Joseph Chabot
    (d’Orléans.)      |  Orleans      |                 |
  St. Laurent         |Montreal       |Hochelaga        |Daniel McDonald,
    (Montreal.)       |               |                 |  Jr.
  St. Lazare          |               |Bellechasse      |D. L’Horty
  St. Léon            |Dumontier      |Maskinongé       |P. O. Lassisseraye
  St. Ligouri         |               |Montcalm         |C. F. P. Renaud
  St. Lin             |               |L’Assomption     |Thomas Garault
  St. Louis de        |               |Beauharnois      |John Symons, Jr.
    Gonzague          |               |                 |
  St. Luc             |Longueuil      |St. John’s       |Samuel Hamilton
  Ste. Luce           |Lessard        |Rimouski         |
  St. Marc            |St. Marc       |Verchères        |John Frazer
  St. Marcel          |               |Richelieu        |G. Ouellet
  Ste. Maguerite      |               |Dorchester       |Louis Roy
  Ste. Marie de Monoir|Monoir         |Rouville         |F. H. Gatien
  Ste. Marthe         |Rigaud         |Vaudreuil        |E. Lalonde
  St. Martin          |Isle Jésus     |Laval            |Charles Smallwood
  Ste. Martine        |Beauharnois    |Chateauguay      |M. A. Primeau
  _St. Mary’s         |Blanshard      |Perth            |Thomas Christie
    (Blanshard.)_     |               |                 |
  St. Mathias         |East Chambly   |Rouville         |Paul Bertrand
  St. Maurice         |               |Champlain        |T. H. Pacaud
  St. Michel          |St. Michel     |Bellechasse      |E. S. Belleau
  St. Modeste         |Wentworth      |Temiscouata      |N. Miville
  Ste. Monique        |Nicolet        |Nicolet          |P. Nourie
  St. Narcisse        |Champlain      |Champlain        |D. Hamelin
  St. Nicholas        |               |Levi             |Morris Scott
  St. Norbert         |Berthier       |Berthier         |E. Grandpré
  St. Ours            |St. Ours       |Richelieu        |L. Chapdelaine
  St. Pacôme          |               |Kamouraska       |Alex. Hudon
  St. Paschal         |Kamouraska     |Kamouraska       |A. Blondeau
  St. Paul d’Industrie|               |Joliette         |
  St. Paul’s Bay      |St. Paul’s Bay |Charlevoix       |T. Fortin
  St. Philippe        |               |Laprairie        |George F. Singer
  Ste. Philomène      |               |Chateauguay      |J. B. D’Amour
  Ste. Pie            |               |Bagot            |J. C. Bachand
  St. Pierre d’Orléans|Island of      |Montmorency      |F. Fortin
                      |  Orleans      |                 |
  St. Pierre          |               |Montmagny        |Charles Bacon
    (Montmagny.)      |               |                 |
  St. Pierre les      |               |Nicolet          |O. Tousignant
    Becquets          |               |                 |
  St. Placide         |               |Two Mountains    |J. E. Cochrane
  St. Polycarpe       |New Longueuil  |Soulanges        |John Taylor
  St. Prosper         |               |Champlain        |Philippe Gerard
  St. Raphael (West)  |Charlottenburg |Glengary         |D. F. McDonell
  St. Raphael (East)  |               |Bellechasse      |F. Goulet
  St. Raymond         |Bourg Louis    |Portneuf         |Edouard Plamondon
  St. Rémi            |La Salle       |Napierville      |Henry Duncan
  St. Roch des Aunais |               |L’Islet          |A. Morin
  St. Roch l’Achigan  |               |L’Assomption     |B. Rocher
  Ste. Rosalie        |St. Hyacinthe  |Bagot            |O. Senecal
  Ste. Rose           |Isle Jésus     |Laval            |W. Miller
  St. Sauveur         |Abercrombie    |Terrebonne       |W. H. Scott
  St. Scholastique    |               |Two Mountains    |H. N.
                      |               |                 |  Delesderniers
  St. Simon de Yamaska|De Ramsay      |Bagot            |
  St. Simon de        |               |Rimouski         |A. Pelletier
    Rimouski          |               |                 |
  Ste. Sophie         |Halifax        |Megantic         |Olivier Hébert
  St. Stanislas       |               |Champlain        |Basilide Roy
  St. Sulpice         |L’Assomption   |L’Assomption     |Denis Bouthillier
  St. Sylvester       |               |Lotbinière       |John Machell
  St. Sylvester, East |               |Lotbinière       |George McCrea
  _Ste. Thérèse de    |Blainville     |Terrebonne       |John Morris
    Blainville_       |               |                 |
  St. Thomas          |Lanoraie       |Berthier         |Louis Voligny
    (Berthier.)       |               |                 |
  _St. Thomas         |St. Thomas     |Montmagny        |J. S. Vallée
    (Montmagny.)_     |               |                 |
  _St. Thomas (West)_ |Yarmouth       |Elgin, E. R.     |E. Ermatinger
                      |               |                 |
  Ste. Timothée       |               |Beauharnois      |J. B. Scott
  St. Urbain          |               |Chateauguay      |C. McGill
  Ste. Ursule         |               |Maskinongé       |L. Lupien
  Ste. Valentine      |               |St. Johns        |F. B. Laperle
  St. Vallier         |St. Vallier    |Bellechasse      |F. Belanger
  Ste. Victoire       |               |Richelieu        |Henry P. Paré
  St. Vincent         |St. Vincent    |Grey             |William Stephenson
  St. Vincent de Paul |Isle Jésus     |Laval            |C. Germain
  St. Zéphirin        |Courval        |Yamaska          |G. Crépeau
  St. Zotique         |               |Soulanges        |O. F. Prieur
                      |               |                 |
                      |               |                 |
  Salem               |Malahide       |Elgin, E. R.     |George Smades
  Salford             |Dereham        |Oxford, S. R.    |Robert Nicholson
  Sandhill            |Albion         |Peel             |Robert Dwyer, Jr.
  Sand Point          |McNab          |Renfrew          |Alexander McDonell
  _Sandwich_          |Sandwich       |Essex            |P. H. Morin
  _Saugeen_           |Saugeen        |Bruce            |Robert Reid
  Sault au Recollet   |Montreal       |Hochelaga        |Edouard Dauphin
  Sault Ste. Marie    |    Entrance to|Lake Superior    |Joseph Wilson
  Sawyerville         |Newport        |Compton          |William Sawyer
  Scarboro’           |Scarboro’      |York, E. R.      |A. MacLean
  Scotch Block        |Esquesing      |Halton           |Thomas Hume
  Scotland            |Oakland        |Brant, W. R.     |H. Lyman
  Scott               |Scott          |Ontario, N. R.   |John Weighall
  Sebringville        |Downie         |Perth            |S. R. Hesson
  Seeley’s Bay        |Leeds          |Leeds, S. R.     |Truman H. Russell
  Selby               |Richmond       |Lenox            |David Wartman
  Selkirk             |Walpole        |Haldimand        |Henry Kent
  _Seneca_            |Seneca         |Haldimand        |James Little
  Seymour, East       |Seymour        |Northumberland,  |David Allan
                      |               |  E. R.          |
  Shakespeare         |S. Easthope    |Perth            |William Cossey
  Shannonville        |Tyendinaga     |Hastings, S. R.  |Hiram Holden
  Sharon              |Gwillimbury, E.|York, N. R.      |John C. Hogaboom
  Shawenegan          |Shawenegan     |St. Maurice      |J. G. Rousseau
  Sheffield           |Beverley       |Wentworth, N. R. |James H. Cooper
  Shefford Mountain   |Shefford       |Shefford         |D. R. Savage
  _Sherbrooke_        |Ascot          |T’n of Sherbrooke|William Brooks
  Sherrington         |Sherrington    |Napierville      |George Busby
  Sillsville          |Fredericksburg |Lenox            |Donovan Sills
  Silver Creek        |Esquesing      |Halton           |A. P. Goodenow
  Silver Hill         |Charlotteville |Norfolk          |Elizabeth Cole
  _Simcoe_            |Woodhouse      |Norfolk          |Henry Mulkins
  Sinclairville       |Seneca         |Haldimand        |Adam A. Davis
  Sligo               |Caledon        |Peel             |Isaac Hunter
  Smithfield          |Brighton       |Northumberland,  |Robert Smith
                      |               |  E. R.          |
  Smith’s Corners     |Murray         |Northumberland,  |Wilmot Gerow
                      |               |  E. R.          |
  _Smith’s Falls_     |N. Elmsley     |Lanark, S. R.    |James Shaw, Jr.
  Smithville,         |Thurlow        |Hastings, S. R.  |William Ashley
    (Hastings.)       |               |                 |
  _Smithville,        |Grimsby        |Lincoln          |Abishai Morse
    (Lincoln.)_       |               |                 |
  Sombra              |Sombra         |Lambton          |P. Catanach
  Somerset            |Somerset       |Megantic         |H. Jutras
  Soraba              |Upton          |Bagot            |S. B. Warner
  South Bolton        |Bolton         |Brome            |Amos Austin
  South Cayuga        |S. Cayuga      |Haldimand        |Isaac Fry
  South Douro         |Douro          |Peterboro’       |Daniel Sullivan
  South Durham        |Durham         |Drummond         |Asa Leighton
  South Elmsley       |S. Elmsley     |Leeds, S. R.     |Elisha Landon
  South Ely           |Ely            |Shefford         |F. R. Blanchard
  South Finch         |Finch          |Stormont         |Nelson Gray
  South Gloucester    |Gloucester     |Carleton         |John O’Doherty
  South Gower         |S. Gower       |Grenville, N. R. |Daniel B. Pelton
  South Granby        |Granby         |Shefford         |Elias Clow
  South Hinchinbrook  |Hinchinbrook   |Huntingdon       |J. Holbrook
  South March         |March          |Carleton         |
  South Monaghan      |South Monaghan |Northumberland,  |John Clemisha
                      |               |  W. R.          |
  South Mountain      |Mountain       |Dundas           |John Morrow
  South Potton        |Potton         |Brome            |Joseph Manson
  South Roxton        |Roxton         |Shefford         |A. Sanborn
  South Westmeath     |Westmeath      |Renfrew          |George Smith
  South Zorra         |Zorra          |Oxford, N. R.    |Thomas Cross
  _Sparta_            |Yarmouth       |Elgin, E. R.     |John A. Eakins
  Spencer Cove        |               |Quebec           |Denis Maguire
  Spencerville        |Edwardsburg    |Grenville, S. R. |W. B. Imrie
  Spike’s Corners     |Portland       |Frontenac        |Barnabas Wartman
  Spring Arbour       |Walsingham     |Norfolk          |Alexander McRae
  Springford          |Norwich        |Oxford, S. R.    |Chauncey Wilcox
  Springville         |Cavan          |Durham, E. R.    |Thomas Eyres
  Stafford            |Stafford       |Renfrew          |Robert Childerhose
  Stamford            |Stamford       |Welland          |Ellen Wilson
  Stanbridge East     |Stanbridge     |Missisquoi       |E. J. Briggs
  Standon             |Standon        |Dorchester       |John Nicholson
  Stanfold            |Stanfold       |Arthabaska       |James Huston
  Stanley’s Mills     |Chinguacousy   |Peel             |A. Griffiths
  _Stanstead_         |Stanstead      |Stanstead        |B. F. Hubbard
  Stevensville        |Bertie         |Welland          |Benjamin House
  _Stirling_          |Rawdon         |Hastings, N. R.  |William Judd
  Stittsville         |Goulburn       |Carleton         |Jackson Stitt
  Stoco               |Hungerford     |Hastings, N. R.  |John Rutledge
  Stoneham            |               |Quebec           |Nicholas Murphy
  _Stoney Creek_      |Saltfleet      |Wentworth, S. R. |J. Williamson
  Stornoway           |Winslow        |Compton          |Colin Noble
  Storrington         |Storrington    |Frontenac        |Hugh Spring
  Stottville          |               |St. Johns        |Daniel Stott
  _Stouffville_       |Whitchurch     |York, N. R.      |
  _Strabane_          |Flamboro’ West |Wentworth, N. R. |Matthew Peebles
  Straffordville      |Bayham         |Elgin, E. R.     |
  _Stratford_         |S. Easthope    |Perth            |Alex. F. Mickle
  Strathburn          |Mosa           |Middlesex, W. R. |Hugh McRae
  Strathroy           |Carradoc       |Middlesex, W. R. |Timothy Cook
  _Streetsville_      |Toronto        |Peel             |W. H. Paterson
  Stukely             |Stukely        |Shefford         |L. H. Brooks
  Sullivan            |Holland        |Grey             |Wm. Buchanan
  Summerstown         |Charlottenburg |Glengary         |David Summers
  Summerville         |Toronto        |Peel             |William Ward
  Sunnidale           |Sunnidale      |Simcoe, N. R.    |Alexander
                      |               |                 |  Gillespie
  Sunnidale Station   |do.            |do.              |Peter Paton
  _Suspension Bridge_ |Stamford       |Welland          |Gilbert McMicken
  Sutherland’s Corners|Euphemia       |Lambton          |James Walker
  Sutton              |Sutton         |Brome            |G. C. Dyer
  Sweetsburgh         |Dunham         |Missisquoi       |G. H. Sweet
  Switzerville        |Ernestown      |Addington        |Calvin W. Miller
  Sydenham Place      |Kingsey        |Drummond         |
  Sylvan              |Williams       |Middlesex, W. R. |Robert Burns
                      |               |                 |
                      |               |                 |
  Tadousac            |               |Saguenay         |Joseph Radford
  Talbotville Royal   |Southwold      |Elgin, W. R.     |J. Spackman
  Tamworth            |Sheffield      |Addington        |Franklin Selden
  Tannery West        |Montreal       |Hochelaga        |P. Carroll
  Tapleytown          |Saltfleet      |Wentworth, S. R. |Daniel Walker
  Tatlock             |Darling        |Lanark, S. R.    |W. T. Janson
  Tecumseth           |Tecumseth      |Simcoe, S. R.    |Robert Clark
  Teeswater           |Culross        |Bruce            |M. Hadwin
  Templeton           |Templeton      |Ottawa           |James Hagan
  Teohauta            |Beauharnois    |Beauharnois      |George Ellis
  _Terrebonne_        |Terrebonne     |Terrebonne       |John McKenzie
  Teviotdale          |Minto          |Wellington, N. R.|Alexr. Scott
  Thamesford          |Nissouri, East |Oxford, N. R.    |Lawrence Whelan
  Thamesville         |Camden         |Kent             |William Mayhew
  Thistletown         |Etobicoke      |York, W. R.      |Edward Tyrrell
  Thomasburg          |Hungerford     |Hastings, N. R.  |W. W. Jones
  Thornbury           |Collingwood    |Grey             |Solomon D.
                      |               |                 |  Olmstead
  _Thornhill_         |Markham        |York, E. R.      |William Parsons
  Thornton            |Innisfil       |Simcoe, S. R.    |John Henry
  _Thorold_           |Thorold        |Welland          |Jacob Keefer
  Thorpville          |Nichol         |Wellington, N. R.|John Thorp
  _Three Rivers_      |Three Rivers   |Town of Three    |C. K. Ogden
                      |               |  Rivers         |
  Thurlow             |Thurlow        |Hastings, S. R.  |John Philips
  Thurso              |Lochaber       |Ottawa           |G. W. Cameron
  Tilbury East        |Tilbury East   |Kent             |James Smith
  Tingwick            |Tingwick       |Arthabaska       |John Murphy
  Toledo              |Kitley         |Leeds and        |W. Chamberlain
                      |               |  Grenville,     |
                      |               |  N. R.          |
  _Toronto_           |York           |City of Toronto  |Joseph Lesslie
  Trafalgar           |Trafalgar      |Halton           |J. L. Bigger
  Trecastle           |Wallace        |Perth            |Freeborn Kee
  Trenholm            |Kingsey        |Drummond         |Simon Stevens
  _Trenton_           |Murray         |Hastings         |James Cumming
  Tring               |Tring          |Beauce           |Z. Bertrand
  Trois Pistoles      |Trois Pistoles |Temiscouata      |T. P. Pelletier
  Trois Saumons       |St. Jean Port  |L’Islet          |G. C. Carron
                      |  Joli         |                 |
  Troy                |Beverley       |Wentworth, N. R. |Alexander
                      |               |                 |  McRoberts
  Tullamore           |Toronto Gore   |Peel             |Reid Wright
  Tuscarora           |Onondaga       |Brant, E. R.     |George Youell
  Tweed               |Hungerford     |Hastings, N. R.  |G. Howell
  Tyrconnell          |Dunwich        |Elgin, W. R.     |James Blackwood
  Tyrone              |Darlington     |Durham, W. R.    |John Grey
                      |               |                 |
                      |               |                 |
  Union               |Yarmouth       |Elgin, E. R.     |James Haight
  Unionville          |Markham        |York, E. R.      |Andrew Eckardt
  Upton               |Upton          |Yamaska          |G. T. Peltier
  Utica               |Reach          |Ontario, N. R.   |Duncan McKercher
  Uxbridge            |Uxbridge       |Ontario, N. R.   |William Smith
                      |               |                 |
                      |               |                 |
  Valcartier          |Valcartier     |Quebec           |Andrew Kerr
  Vallentyne          |Brock          |Ontario, N. R.   |Henry Brethour
  Valleyfield         |Beauharnois    |Beauharnois      |John Madden
  _Vankleek Hill_     |Hawkesbury     |Prescott         |Duncan McDonell
  Varennes            |Varennes       |Verchères        |Jacques L. de
                      |               |                 |  Martigny
  Varna               |Stanley        |Huron            |Josiah B. Secord
  Vaudreuil           |Vaudreuil      |Vaudreuil        |H. F. Charlebois
  Verchères           |Verchères      |Verchères        |Trefflé Lussier
  Vernonville         |Haldimand      |Northumberland,  |Donald McRae
                      |               |  W. R.          |
  Victoria Corners    |Reach          |Ontario          |C. B. Colhoun
  Victoria Square     |Markham        |York, E. R.      |Humphry White
  _Vienna_            |Bayham         |Elgin, E. R.     |John Alexander
  Villanova           |Townsend       |Norfolk          |John McLaren
  _Vittoria_          |Charlotteville |Norfolk          |Simpson McCall
  Vroomanton          |Brock          |Ontario, N. R.   |Murdoch McPhaden
                      |               |                 |
                      |               |                 |
  Wainfleet Centre    |Wainfleet      |Welland          |Lemuel S. Yokom
  Wakefield           |Wakefield      |Ottawa           |James McLaren
  Wallace             |Wallace        |Perth            |Charles Burrows
  Wallaceburg         |Sombra         |Lambton          |James Riddle
  Wallacetown         |Dunwich        |Elgin, W. R.     |J. Mayhen
  Walmer              |Peel           |Wellington, N. R.|J. W. Lowes
  Walsingham          |Walsingham     |Norfolk          |Henry L. Kitchen
  Walter’s Falls      |Holland        |Grey             |John Walter
  _Wardsville_        |Mosa           |Middlesex        |Henry R. Archer
  Warner              |Caistor        |Lincoln          |M. Warner
  Warsaw              |Dummer         |Peterboro’       |Thomas Choate
  Warwick, L. C.      |Warwick        |Arthabaska       |Enos Farwell
  _Warwick, U. C._    |Warwick        |Lambton          |John A. Woodrooffe
  Washington          |Blenheim       |Oxford, N. R.    |Daniel Wakefield
  _Waterdown_         |Flamboro’ East |Wentworth, N. R. |Henry Edwards
  _Waterford_         |Townsend       |Norfolk          |James L. Green
  _Waterloo, L. C._   |Shefford       |Shefford         |Jonathan Robinson
  Waterloo, U. C.     |Waterloo, N.   |Waterloo, N. R.  |Daniel Snyder
  Waterloo, Kingston  |Kingston       |Frontenac        |Joseph Northmore
  Waterville          |Compton        |Compton          |Israel Wood
  Watford             |Warwick        |Lambton          |Richard Browne
  Watson’s Corners    |Dalhousie      |Lanark, N. R.    |William Watson
  [8]Wawanosh         |Wawanosh       |Huron            |John Kaine
  Weedon              |Weedon         |Wolfe            |Simeon Fontaine
  Welland Port        |Gainsboro’     |Lincoln          |Samuel Holmes
  Wellesley           |Wellesley      |Waterloo, N. R.  |John Zöeger
  Wellington          |Hillier        |Prince Edward    |Archibald McFaul
  _Wellington Square_ |Nelson         |Halton           |W. N. Watts
  Wellman’s Corners   |Rawdon         |Hastings, N. R.  |John F. Kelly
  West Arran          |Arran          |Bruce            |A. Dalgleish
  West Bolton         |Bolton         |Brome            |John McMannis
  West Brome          |Brome          |Brome            |Ephraim Keyes
  West’s Corners      |Mornington     |Perth            |David Matthews
  West Essa           |Essa           |Simcoe, S. R.    |Thomas Drury
  West Farnham        |Farnham        |Missisquoi       |Robert McCorkill
  Westfield           |Wawanosh       |Huron            |H. Help
  _West Flamboro’_    |Flamboro’      |Wentworth, N. R. |Walter Colcleugh
  West Huntingdon     |Huntingdon     |Hastings, N. R.  |Philip Luke
  West Huntley        |Huntley        |Carleton         |Edward Horan
  West McGillivray    |McGillivray    |Huron            |
  Westmeath           |Westmeath      |Renfrew          |M. M. Drew
  Westminster         |Westminster    |Middlesex, E. R. |James Riley
  _Weston_            |York           |York, W. R.      |John A. Donaldson
  Westover            |Beverley       |Wentworth        |John Westover
  West Osgoode        |Osgoode        |Carleton         |John C. Bower
  West Port           |North Crosby   |Leeds, S. R.     |Walter Whelan
  West Shefford       |Shefford       |Shefford         |P. A. Wood
  West Winchester     |Winchester     |Dundas           |William Bow
  West Woolwich       |Woolwich       |Waterloo, N. R.  |Edward Bristow
  _Whitby_            |Whitby         |Ontario, S. R.   |Alexander
                      |               |                 |  McPherson
  Whitehall           |Camden         |Kent             |James Shaw
  White Lake          |McNab          |Renfrew          |John Paris
  Whitfield           |Mulmur         |Simcoe, S. R.    |Robert Campbell
  Wick                |Brock          |Ontario, N. R.   |
  Widder              |Bosanquet      |Lambton          |Robert Rae
  Wilkesport          |Sombra         |Lambton          |Daniel Meyers
  _William Henry      |Sorel          |Richelieu        |J. O. Duplessis
    (Sorel.)_         |               |                 |
  _Williams_          |Williams       |Middlesex, W. R. |Colin McKenzie
  Williamstown        |Charlottenburg |Glengary         |Duncan McLennan
  Williscroft         |Elderslie      |Bruce            |George Williscroft
  Willocks            |Verulam        |Victoria         |James Willocks
  Willowdale          |Vaughan        |York, W. R.      |Jacob Cumner
  Wilton              |Ernestown      |Addington        |Sydney Warner
  Winchester          |Winchester     |Dundas           |Robert H. Rose
  Windham Centre      |Windham        |Norfolk          |D. H. Dodge
  _Windsor_           |Sandwich       |Essex            |D. Ouellette
  Windsor Mills       |Windsor        |Richmond         |C. E. Wurtele
  Wisbeach            |Warwick        |Lambton          |John Bowes
  [9]Woburn           |Scarboro’      |York, E. R.      |James Osburne
  Wolfe Island        |Wolfe Island   |Frontenac        |Mary Hitchcock
  Wolfstown           |Wolfstown      |Wolfe            |Levi Hodgkinson
  Wolverton           |Blenheim       |Oxford, N. R.    |Enos Wolverton
  _Woodbridge_        |Vaughan        |York, W. R.      |John T. Howell
  Woodburn            |Binbrook       |Wentworth, S. R. |William Ptolemy
  Woodbury            |Bosanquet      |Lambton          |Thomas Woods
  Woodford            |Sydenham       |Grey             |Thomas Elliot
  Woodside            |Halifax        |Megantic         |Thomas Wood
  _Woodstock_         |Blandford      |Oxford, N. R.    |Charles
                      |               |                 |  DeBlaquière
  Woodville           |Eldon          |Victoria         |John Morison
  Woolwich            |Woolwich       |Waterloo, N. R.  |John Gordon
  Wotton              |Wotton         |Wolfe            |T. D. Richard
  Wyton               |Nissouri, W.   |Middlesex, E. R. |Peter Van Every
                      |               |                 |
                      |               |                 |
  Yamachiche          |Machiche       |St. Maurice      |Petrus Hubert
  Yamaska             |Yamaska        |Yamaska          |E. G. Dugré
  _York_              |Seneca         |Haldimand        |Charles L. Hudson
  York Mills          |York           |York, W. R.      |John Hogg
  Yorkville           |York           |York, W. R.      |James Dobson
                      |               |                 |
                      |               |                 |
  Zetland             |Turnberry      |Huron            |A. Becket
  Zimmerman           |Nelson         |Halton           |H. P. Zimmerman
  --------------------+---------------+-----------------+-----------------

[1] Closed during winter.

[2] Late Pelham.

[3] Late “Carstairs.”

[4] Late East Plympton.

[5] Late Mariposa.

[6] Late “Plympton.”

[7] Late “Temperanceville.”

[8] Changed to Dungannon.

[9] Late Elderslie.




LIST OF CHANGES that have been made in the NAMES OF POST OFFICES, between
the 1st July, 1855, and 1st November, 1856, inclusive.


  ==========================+==============================+=============
  LATE NAME OF POST OFFICE. |ELECTORAL COUNTY OR DIVISION. |NEW NAME
                            |                              |SELECTED.
  --------------------------+------------------------------+-------------
  Carradoc                  |Middlesex, W. R.              |Mount Brydges
  Carstairs (Vroomenia)     |Brant                         |Harrisburg
  East Plympton             |Lambton                       |Kertch
  Elderslie                 |York, E. R.                   |Woburn
  Emily                     |Victoria                      |Omamee
  Hopeville                 |Durham, E. R.                 |Canton
  Kitley                    |Leeds and Grenville, N. R.    |Toledo
  Mariposa                  |Victoria                      |Manilla
  Mill Creek                |Addington                     |Odessa
  Mosa                      |Middlesex, W. R.              |Wardsville
  Pelham                    |Welland                       |Fonthill
  Pine Hill                 |Lambton                       |Widder
  Plympton                  |Lambton                       |Oban
  Rupert                    |York, W. R.                   |Maple
  Temperanceville           |Elgin, E. R.                  |Orwell
  Walpole                   |Haldimand                     |Selkirk
  Wawanosh                  |Huron                         |Dungannon
  Wilksburg                 |Lambton                       |Wilkesport
  Wilmot                    |Waterloo, S. R.               |Haysville
  Zone Mills                |Lambton                       |Florence
  --------------------------+------------------------------+-------------




Changes that have been made in the names of Post Offices since 1st Nov.,
1856.


  =====================+============+=================+==================
  LATE NAME OF OFFICE. |TOWNSHIP.   |COUNTY.          |NEW NAME SELECTED.
  ---------------------+------------+-----------------+------------------
  Beverley             |Bastard     |Leeds            |_Delta_
  Biddulph             |Biddulph    |Huron            |Adare
  Brown’s Corners      |Pickering   |Ontario, S. R.   |Audley
  Crosby’s Corners     |Markham     |York, E. R.      |Cashel
  Cumberland           |Cumberland  |Russell          |Osborne
  East Holland         |Holland     |Grey             |Chatsworth
  Finch                |Finch       |Stormont         |Berwick
  Gormley’s Corners    |Markham     |York, E. R.      |Gormley
  Hall’s Mills         |Westminster |Middlesex, E. R. |Byron
  Holland              |Holland     |Grey             |Berkeley
  Mad River Mills      |Osprey      |Grey             |Mortimer
  Mill Point           |Richmond    |Lenox            |Bowen
  St. George           |Huntingdon  |Hastings, N. R.  |Ivanhoe
  Suspension Bridge    |Stamford    |Welland          |_Clifton_
  Tingwick             |Arthabaska  |Arthabaska       |Castlebar
  Westminster          |Westminster |Middlesex, E. R. |Lambeth
  ---------------------+------------+-----------------+------------------




SUPPLEMENTARY LIST of Post Offices established in Canada between 1st
October, 1856, and 1st March, 1857, inclusive.


  =============+=============+===============+================+============
               |  TOWNSHIP   |               |                |
               |    IF IN    |               |                |
               |CANADA WEST, |               |                |
               |AND TOWNSHIP,|               |                |
               | SEIGNIORY OR|   ELECTORAL   |                |DATE OF
  NAME OF      |PARISH, IF IN|    COUNTY     |                |GOING INTO
  POST OFFICE. | CANADA EAST.|  OR DIVISION. | POSTMASTER.    |OPERATION.
  -------------+-------------+---------------+----------------+------------
  Abingdon     |Caistor      |Lincoln        |Andrew Wilson   |1st Dec’mr.,
               |             |               |                |  1856
  Aldershott   |Flamboro’,   |Wentworth,     |Alexander Brown |1st do do
               |  East       |  N. R.        |                |
  Almira       |Markham      |York, E. R.    |B. Bowman       |1st January,
               |             |               |                |  1857
  Appleby      |Nelson       |Halton         |T. A. Atkinson  |1st March,
               |             |               |                |  do
  Apto         |Vespra       |Simcoe, N. R.  |Malcolm Stewart |1st Nove’r.,
               |             |               |                |  1856
  Ayton        |Normanby     |Grey           |Joseph Dixon    |1st March,
               |             |               |                |  1857
  Bewdley      |Hamilton     |Northumberland,|John Sidey      |1st January,
               |             |  W. R.        |                |  do
  Blessington  |Tyendinaga   |Hastings, S. R.|John Hayes      |1st Dec’mr.,
               |             |               |                |  1856
  Bomanton     |Haldimand    |Northumberland,|William Campbell|1st March,
               |             |  W. R.        |                |  1857
  Britonville  |Morin        |Argenteuil     |Geo. Hamilton   |1st
               |             |               |                |  February,
               |             |               |                |  do
  Carlingford  |Fullarton    |Perth          |A. Davidson     |1st Dec’mr.,
               |             |               |                |  1856
  Cashmere     |Mosa         |Middlesex,     |E. M. Heal      |1st January,
               |             |  W. R.        |                |  1857
  Comber,      |Tilbury, West|Essex          |Hy. Reichenback |1st do do
    re-open’d  |             |               |                |
  Constance    |Hullett      |Huron          |John Lawson     |1st do do
  Craigleith   |Collingwood  |Grey           |A. G. Fleming   |1st do do
  Cromarty     |Hibbert      |Perth          |John McLaren    |1st Dec’mr.,
               |             |               |                |  1856
  Dundalk      |Melancthon   |Grey           |Elias B. Grey   |1st do do
  Forcastle    |Thora        |Ontario, N. R. |Daniel Cameron  |1st Feb’ry.,
               |             |               |                |  1857
  Fournier     |Plantagenet  |Prescott       |C. Fournier     |1st Dec’mr.,
               |             |               |                |  1856
  Glencoe      |Ekfrid       |Middlesex,     |Donald McRae    |1st October,
               |             |  N. R.        |                |  1856
  Gourock      |Guelph       |Wellington,    |James Mewhart   |1st January,
               |             |  S. R.        |                |  1857
  Kaladar      |Kaladar      |Addington      |E. F. Dunham    |1st do do
  Keith        |Dawn         |Lambton        |William Findley |1st March,
               |             |               |                |  1857
  Kendall      |Clarke       |Darham, W. R.  |W. Trull        |1st Feb.,
               |             |               |                |  1857
  Kenmore      |Osgoode      |Russell        |A. Dewar        |1st March,
               |             |               |                |  1857
  Kilbride     |Nelson       |Halton         |William Panton  |1st Dec.,
               |             |               |                |  1856
  Kinkora      |Ellice       |Perth          |William Hearsnip|1st Feb.,
               |             |               |                |  1857
  La           |La           |St. Hyacinthe  |N. Bergeron     |1st January,
  Présentation |Présentation |               |                |  1857
  Laterrière   |Notre Dame du|Chicoutimi     |George McKenzie |1st Nov.,
               |  Grand Brulé|               |                |  1856
  Leaskdale    |Scott        |Ontario, N. R. |G. Leask        |1st Feb.,
               |             |               |                |  1857
  Le Foulon    |Hawkesbury   |Prescott       |William Jamieson|1st do do
    (re-op.)   |             |               |                |
  Lockton      |Albion       |Peel           |Archd. Locke    |1st January,
               |             |               |                |  1857
  Malton       |Toronto      |Peel           |Isaac H.        |1st October,
               |             |               |  Sanderson     |  1856
  Malvern      |Scarborough  |York, E. R.    |David Brown     |1st do do
  Mattawa      |Ottawa River, 90 miles above |G. Hunter       |1st Dec.,
               |  Pembroke, where canoe route|                |  1856
               |  from Lake Huron joins the  |                |
               |  Ottawa                     |                |
  Mount Healey |Oneida       |Haldimand      |John Donaldson  |1st Feb.,
               |             |               |                |  1857
  Muncey       |Carradoc     |Middlesex,     |James Musgrove  |1st January,
               |             |  W. R.        |                |  1857
  Newstadt     |Normanby     |Grey           |D. Winkler      |1st do do
  Newbliss     |Kitley       |Leeds &        |John Edgar      |1st March,
               |             |  Grenville,   |                |  1857
               |             |  N. R.        |                |
  Newry        |Mauvers      |Durham, E. R.  |J. A. Johnson   |1st January,
               |             |               |                |  1857
  Ringwood     |Whitchurch   |York, N. R.    |G. H. Silvester |1st do do
  Rockport     |Escott       |Leeds, S. R.   |William Cornwall|1st Feb.,
               |             |               |                |  1857
  Roxborough   |Roxborough   |Stormont       |C. McRea        |1st Nov.,
    West       |             |               |                |  1856
  St. Ives     |W. Nissouri  |Middlesex,     |Thomas Howard   |1st Feb.,
               |             |  E. R.        |                |  1857
  Sheridan     |Toronto      |Peel           |N. Henriod      |1st March,
               |             |               |                |  1857
  Weimar       |Wellesley    |Waterloo, N. R.|F. Walter       |1st do do
  Wicklow      |Haldimand    |Northumberland |John Wilson     |1st do do
    (re-op’d.) |             |               |                |
  Zurich       |Hay          |Huron          |Frederick Knell |1st Nov.,
               |             |               |                |  1856
  -------------+-------------+---------------+----------------+------------




Offices Closed since 1st October, 1856.


  =====================+===========+====================
  NAME OF POST OFFICE. |TOWNSHIP.  |COUNTY.
  ---------------------+-----------+--------------------
  Flint                |Kaladar    |Addington
  Kilmarnock           |Montague   |Lanark, South Riding
  Louisville           |Chatham    |Kent
  Port Milford         |Marysburgh |Prince Edward
  ---------------------+-----------+--------------------

                              (MEMORANDUM.)
       Postmasters will please correct their Lists of Post Offices
                              accordingly.




Offices at which there has been a change of Postmaster since 1st
September, 1856.


  ===============================+=======================
  OFFICE.                        |PRESENT POSTMASTER.
  -------------------------------+-----------------------
  Artemesia                      |John Flesher.
  Batiscan                       |J. B. Provost.
  Beaverton                      |Charles Robinson.
  Belle Rivière                  |J. B. Lemery.
  Bowmanville                    |J. B. Fairbairn.
  Brompton                       |E. B. Stevens.
  Bruce Mines                    |J. Coatsworth.
  Buttonville                    |Martin Scott.
  Buxton                         |Peter Nichol.
  Campbell’s Cross               |E. T. Hagyard.
  Clareview                      |S. S. Macdonnell.
  Culloden                       |Duncan Smith.
  Cumminsville                   |Thomas Galloway.
  Cumnock                        |James Samson.
  Devon                          |Isaac Quick.
  Dorchester Station             |J. N. Hardy.
  Drumbo                         |James McKenzie.
  Eganville                      |Andrew W. Bell.
  Everton                        |Alexander Canady.
  Fenelon Falls                  |James Fitzgerald.
  Ferguson’s Falls               |Robert Hicks.
  Frost Village                  |B. M. Martin.
  Fulton                         |R. Lounsbury.
  Gower Point                    |John Burrill.
  Hagersville                    |Charles Hager.
  Halifax                        |P. C. Pelletier.
  Houghton                       |Jacob Burger.
  Humber                         |John Gardhouse.
  Johnson’s Mills                |Donald McDonell.
  Kinburn                        |David Lions.
  Kincardine                     |M. McKendrick.
  Kingsey                        |George Brock.
  Kippen                         |Charles Lobb.
  Lakeside                       |Hugh Holmes.
  Largie                         |D. McCallum.
  Leith                          |James Ross, Senr.
  Lobo                           |William Fares.
  Lowville                       |R. P. Rogers.
  Mallorytown                    |Frederick F. Lee.
  Maidstone                      |Charles Bennet.
  Marysville                     |John McCambridge.
  Mono Mills                     |James McLaughlin.
  Murray                         |James L. Biggar.
  Newbury                        |George C. Secord.
  New Dundee                     |Christian Ernst.
  Nobleton                       |William Munsie.
  North Sutton                   |Solomon Sweet.
  Nottawa                        |Andrew Milville.
  Otanabee                       |George Read.
  Pointe aux Trembles (Portneuf) |Damas Bernard.
  Pontiac Mills                  |William Davis.
  Port Stanley                   |Samuel Price.
  Prospect                       |John Burrows.
  Ravenswood                     |Jacob Rogers.
  Richmond West                  |R. B. Eagar.
  Rockford                       |John Bottomby.
  Rondeau                        |J. K. Morris.
  St. Jean, Port Joli            |Mathilde Fournier.
  Ste. Martine                   |François Gagné.
  St. Norbert                    |J. B. Denis.
  St. Paul d’Industrie           |Medard Haut dit Chausse.
  Ste. Rose                      |J. B. Filiatrault.
  Saugeen                        |
  Silver Creek                   |E. Graham.
  South March                    |Samuel Scisson.
  Spike’s Corners                |Samuel Stewart.
  Stoney Creek                   |Alva G. Jones.
  Stouffville                    |Samuel Fenton.
  Straffordville                 |R. J. McNaughton.
  Streetsville                   |John McMaster.
  Vaudreuil                      |Mrs. DeSalles Bastien.
  Wallacetown                    |W. D. Meikle.
  West McGillvray                |P. Macguire.
  Westminster (now Lambeth.)     |John Chalmers.
  Wick                           |Peter Carmichael.
  Yamachiche                     |Dr. E. Lacerte.
  -------------------------------+------------------------




ERRATA IN GENERAL LIST.

Offices in operation prior to 1st October, but omitted in the List.


  =====================+===========+===========+===================
  Name of Post Office. |Township.  |County.    |Postmaster.
  ---------------------+-----------+-----------+-------------------
  Maddington           |Maddington |Arthabaska |Venant St. Germain.
  Westbury             |Westbury   |Compton    |Reuben Hall.
  ---------------------+-----------+-----------+-------------------

Onondaga is in the Township of Onondaga.

Willowdale is in the Township of York.



*** END OF THE PROJECT GUTENBERG EBOOK LIST OF POST OFFICES IN CANADA, WITH THE NAMES OF THE POSTMASTERS ... 1856 ***


    

Updated editions will replace the previous one—the old editions will
be renamed.

Creating the works from print editions not protected by U.S. copyright
law means that no one owns a United States copyright in these works,
so the Foundation (and you!) can copy and distribute it in the United
States without permission and without paying copyright
royalties. Special rules, set forth in the General Terms of Use part
of this license, apply to copying and distributing Project
Gutenberg™ electronic works to protect the PROJECT GUTENBERG™
concept and trademark. Project Gutenberg is a registered trademark,
and may not be used if you charge for an eBook, except by following
the terms of the trademark license, including paying royalties for use
of the Project Gutenberg trademark. If you do not charge anything for
copies of this eBook, complying with the trademark license is very
easy. You may use this eBook for nearly any purpose such as creation
of derivative works, reports, performances and research. Project
Gutenberg eBooks may be modified and printed and given away—you may
do practically ANYTHING in the United States with eBooks not protected
by U.S. copyright law. Redistribution is subject to the trademark
license, especially commercial redistribution.


START: FULL LICENSE

THE FULL PROJECT GUTENBERG LICENSE

PLEASE READ THIS BEFORE YOU DISTRIBUTE OR USE THIS WORK

To protect the Project Gutenberg™ mission of promoting the free
distribution of electronic works, by using or distributing this work
(or any other work associated in any way with the phrase “Project
Gutenberg”), you agree to comply with all the terms of the Full
Project Gutenberg™ License available with this file or online at
www.gutenberg.org/license.

Section 1. General Terms of Use and Redistributing Project Gutenberg™
electronic works

1.A. By reading or using any part of this Project Gutenberg™
electronic work, you indicate that you have read, understand, agree to
and accept all the terms of this license and intellectual property
(trademark/copyright) agreement. If you do not agree to abide by all
the terms of this agreement, you must cease using and return or
destroy all copies of Project Gutenberg™ electronic works in your
possession. If you paid a fee for obtaining a copy of or access to a
Project Gutenberg™ electronic work and you do not agree to be bound
by the terms of this agreement, you may obtain a refund from the person
or entity to whom you paid the fee as set forth in paragraph 1.E.8.

1.B. “Project Gutenberg” is a registered trademark. It may only be
used on or associated in any way with an electronic work by people who
agree to be bound by the terms of this agreement. There are a few
things that you can do with most Project Gutenberg™ electronic works
even without complying with the full terms of this agreement. See
paragraph 1.C below. There are a lot of things you can do with Project
Gutenberg™ electronic works if you follow the terms of this
agreement and help preserve free future access to Project Gutenberg™
electronic works. See paragraph 1.E below.

1.C. The Project Gutenberg Literary Archive Foundation (“the
Foundation” or PGLAF), owns a compilation copyright in the collection
of Project Gutenberg™ electronic works. Nearly all the individual
works in the collection are in the public domain in the United
States. If an individual work is unprotected by copyright law in the
United States and you are located in the United States, we do not
claim a right to prevent you from copying, distributing, performing,
displaying or creating derivative works based on the work as long as
all references to Project Gutenberg are removed. Of course, we hope
that you will support the Project Gutenberg™ mission of promoting
free access to electronic works by freely sharing Project Gutenberg™
works in compliance with the terms of this agreement for keeping the
Project Gutenberg™ name associated with the work. You can easily
comply with the terms of this agreement by keeping this work in the
same format with its attached full Project Gutenberg™ License when
you share it without charge with others.

1.D. The copyright laws of the place where you are located also govern
what you can do with this work. Copyright laws in most countries are
in a constant state of change. If you are outside the United States,
check the laws of your country in addition to the terms of this
agreement before downloading, copying, displaying, performing,
distributing or creating derivative works based on this work or any
other Project Gutenberg™ work. The Foundation makes no
representations concerning the copyright status of any work in any
country other than the United States.

1.E. Unless you have removed all references to Project Gutenberg:

1.E.1. The following sentence, with active links to, or other
immediate access to, the full Project Gutenberg™ License must appear
prominently whenever any copy of a Project Gutenberg™ work (any work
on which the phrase “Project Gutenberg” appears, or with which the
phrase “Project Gutenberg” is associated) is accessed, displayed,
performed, viewed, copied or distributed:

    This eBook is for the use of anyone anywhere in the United States and most
    other parts of the world at no cost and with almost no restrictions
    whatsoever. You may copy it, give it away or re-use it under the terms
    of the Project Gutenberg License included with this eBook or online
    at www.gutenberg.org. If you
    are not located in the United States, you will have to check the laws
    of the country where you are located before using this eBook.
  
1.E.2. If an individual Project Gutenberg™ electronic work is
derived from texts not protected by U.S. copyright law (does not
contain a notice indicating that it is posted with permission of the
copyright holder), the work can be copied and distributed to anyone in
the United States without paying any fees or charges. If you are
redistributing or providing access to a work with the phrase “Project
Gutenberg” associated with or appearing on the work, you must comply
either with the requirements of paragraphs 1.E.1 through 1.E.7 or
obtain permission for the use of the work and the Project Gutenberg™
trademark as set forth in paragraphs 1.E.8 or 1.E.9.

1.E.3. If an individual Project Gutenberg™ electronic work is posted
with the permission of the copyright holder, your use and distribution
must comply with both paragraphs 1.E.1 through 1.E.7 and any
additional terms imposed by the copyright holder. Additional terms
will be linked to the Project Gutenberg™ License for all works
posted with the permission of the copyright holder found at the
beginning of this work.

1.E.4. Do not unlink or detach or remove the full Project Gutenberg™
License terms from this work, or any files containing a part of this
work or any other work associated with Project Gutenberg™.

1.E.5. Do not copy, display, perform, distribute or redistribute this
electronic work, or any part of this electronic work, without
prominently displaying the sentence set forth in paragraph 1.E.1 with
active links or immediate access to the full terms of the Project
Gutenberg™ License.

1.E.6. You may convert to and distribute this work in any binary,
compressed, marked up, nonproprietary or proprietary form, including
any word processing or hypertext form. However, if you provide access
to or distribute copies of a Project Gutenberg™ work in a format
other than “Plain Vanilla ASCII” or other format used in the official
version posted on the official Project Gutenberg™ website
(www.gutenberg.org), you must, at no additional cost, fee or expense
to the user, provide a copy, a means of exporting a copy, or a means
of obtaining a copy upon request, of the work in its original “Plain
Vanilla ASCII” or other form. Any alternate format must include the
full Project Gutenberg™ License as specified in paragraph 1.E.1.

1.E.7. Do not charge a fee for access to, viewing, displaying,
performing, copying or distributing any Project Gutenberg™ works
unless you comply with paragraph 1.E.8 or 1.E.9.

1.E.8. You may charge a reasonable fee for copies of or providing
access to or distributing Project Gutenberg™ electronic works
provided that:

    • You pay a royalty fee of 20% of the gross profits you derive from
        the use of Project Gutenberg™ works calculated using the method
        you already use to calculate your applicable taxes. The fee is owed
        to the owner of the Project Gutenberg™ trademark, but he has
        agreed to donate royalties under this paragraph to the Project
        Gutenberg Literary Archive Foundation. Royalty payments must be paid
        within 60 days following each date on which you prepare (or are
        legally required to prepare) your periodic tax returns. Royalty
        payments should be clearly marked as such and sent to the Project
        Gutenberg Literary Archive Foundation at the address specified in
        Section 4, “Information about donations to the Project Gutenberg
        Literary Archive Foundation.”
    
    • You provide a full refund of any money paid by a user who notifies
        you in writing (or by e-mail) within 30 days of receipt that s/he
        does not agree to the terms of the full Project Gutenberg™
        License. You must require such a user to return or destroy all
        copies of the works possessed in a physical medium and discontinue
        all use of and all access to other copies of Project Gutenberg™
        works.
    
    • You provide, in accordance with paragraph 1.F.3, a full refund of
        any money paid for a work or a replacement copy, if a defect in the
        electronic work is discovered and reported to you within 90 days of
        receipt of the work.
    
    • You comply with all other terms of this agreement for free
        distribution of Project Gutenberg™ works.
    

1.E.9. If you wish to charge a fee or distribute a Project
Gutenberg™ electronic work or group of works on different terms than
are set forth in this agreement, you must obtain permission in writing
from the Project Gutenberg Literary Archive Foundation, the manager of
the Project Gutenberg™ trademark. Contact the Foundation as set
forth in Section 3 below.

1.F.

1.F.1. Project Gutenberg volunteers and employees expend considerable
effort to identify, do copyright research on, transcribe and proofread
works not protected by U.S. copyright law in creating the Project
Gutenberg™ collection. Despite these efforts, Project Gutenberg™
electronic works, and the medium on which they may be stored, may
contain “Defects,” such as, but not limited to, incomplete, inaccurate
or corrupt data, transcription errors, a copyright or other
intellectual property infringement, a defective or damaged disk or
other medium, a computer virus, or computer codes that damage or
cannot be read by your equipment.

1.F.2. LIMITED WARRANTY, DISCLAIMER OF DAMAGES - Except for the “Right
of Replacement or Refund” described in paragraph 1.F.3, the Project
Gutenberg Literary Archive Foundation, the owner of the Project
Gutenberg™ trademark, and any other party distributing a Project
Gutenberg™ electronic work under this agreement, disclaim all
liability to you for damages, costs and expenses, including legal
fees. YOU AGREE THAT YOU HAVE NO REMEDIES FOR NEGLIGENCE, STRICT
LIABILITY, BREACH OF WARRANTY OR BREACH OF CONTRACT EXCEPT THOSE
PROVIDED IN PARAGRAPH 1.F.3. YOU AGREE THAT THE FOUNDATION, THE
TRADEMARK OWNER, AND ANY DISTRIBUTOR UNDER THIS AGREEMENT WILL NOT BE
LIABLE TO YOU FOR ACTUAL, DIRECT, INDIRECT, CONSEQUENTIAL, PUNITIVE OR
INCIDENTAL DAMAGES EVEN IF YOU GIVE NOTICE OF THE POSSIBILITY OF SUCH
DAMAGE.

1.F.3. LIMITED RIGHT OF REPLACEMENT OR REFUND - If you discover a
defect in this electronic work within 90 days of receiving it, you can
receive a refund of the money (if any) you paid for it by sending a
written explanation to the person you received the work from. If you
received the work on a physical medium, you must return the medium
with your written explanation. The person or entity that provided you
with the defective work may elect to provide a replacement copy in
lieu of a refund. If you received the work electronically, the person
or entity providing it to you may choose to give you a second
opportunity to receive the work electronically in lieu of a refund. If
the second copy is also defective, you may demand a refund in writing
without further opportunities to fix the problem.

1.F.4. Except for the limited right of replacement or refund set forth
in paragraph 1.F.3, this work is provided to you ‘AS-IS’, WITH NO
OTHER WARRANTIES OF ANY KIND, EXPRESS OR IMPLIED, INCLUDING BUT NOT
LIMITED TO WARRANTIES OF MERCHANTABILITY OR FITNESS FOR ANY PURPOSE.

1.F.5. Some states do not allow disclaimers of certain implied
warranties or the exclusion or limitation of certain types of
damages. If any disclaimer or limitation set forth in this agreement
violates the law of the state applicable to this agreement, the
agreement shall be interpreted to make the maximum disclaimer or
limitation permitted by the applicable state law. The invalidity or
unenforceability of any provision of this agreement shall not void the
remaining provisions.

1.F.6. INDEMNITY - You agree to indemnify and hold the Foundation, the
trademark owner, any agent or employee of the Foundation, anyone
providing copies of Project Gutenberg™ electronic works in
accordance with this agreement, and any volunteers associated with the
production, promotion and distribution of Project Gutenberg™
electronic works, harmless from all liability, costs and expenses,
including legal fees, that arise directly or indirectly from any of
the following which you do or cause to occur: (a) distribution of this
or any Project Gutenberg™ work, (b) alteration, modification, or
additions or deletions to any Project Gutenberg™ work, and (c) any
Defect you cause.

Section 2. Information about the Mission of Project Gutenberg™

Project Gutenberg™ is synonymous with the free distribution of
electronic works in formats readable by the widest variety of
computers including obsolete, old, middle-aged and new computers. It
exists because of the efforts of hundreds of volunteers and donations
from people in all walks of life.

Volunteers and financial support to provide volunteers with the
assistance they need are critical to reaching Project Gutenberg™’s
goals and ensuring that the Project Gutenberg™ collection will
remain freely available for generations to come. In 2001, the Project
Gutenberg Literary Archive Foundation was created to provide a secure
and permanent future for Project Gutenberg™ and future
generations. To learn more about the Project Gutenberg Literary
Archive Foundation and how your efforts and donations can help, see
Sections 3 and 4 and the Foundation information page at www.gutenberg.org.

Section 3. Information about the Project Gutenberg Literary Archive Foundation

The Project Gutenberg Literary Archive Foundation is a non-profit
501(c)(3) educational corporation organized under the laws of the
state of Mississippi and granted tax exempt status by the Internal
Revenue Service. The Foundation’s EIN or federal tax identification
number is 64-6221541. Contributions to the Project Gutenberg Literary
Archive Foundation are tax deductible to the full extent permitted by
U.S. federal laws and your state’s laws.

The Foundation’s business office is located at 809 North 1500 West,
Salt Lake City, UT 84116, (801) 596-1887. Email contact links and up
to date contact information can be found at the Foundation’s website
and official page at www.gutenberg.org/contact

Section 4. Information about Donations to the Project Gutenberg
Literary Archive Foundation

Project Gutenberg™ depends upon and cannot survive without widespread
public support and donations to carry out its mission of
increasing the number of public domain and licensed works that can be
freely distributed in machine-readable form accessible by the widest
array of equipment including outdated equipment. Many small donations
($1 to $5,000) are particularly important to maintaining tax exempt
status with the IRS.

The Foundation is committed to complying with the laws regulating
charities and charitable donations in all 50 states of the United
States. Compliance requirements are not uniform and it takes a
considerable effort, much paperwork and many fees to meet and keep up
with these requirements. We do not solicit donations in locations
where we have not received written confirmation of compliance. To SEND
DONATIONS or determine the status of compliance for any particular state
visit www.gutenberg.org/donate.

While we cannot and do not solicit contributions from states where we
have not met the solicitation requirements, we know of no prohibition
against accepting unsolicited donations from donors in such states who
approach us with offers to donate.

International donations are gratefully accepted, but we cannot make
any statements concerning tax treatment of donations received from
outside the United States. U.S. laws alone swamp our small staff.

Please check the Project Gutenberg web pages for current donation
methods and addresses. Donations are accepted in a number of other
ways including checks, online payments and credit card donations. To
donate, please visit: www.gutenberg.org/donate.

Section 5. General Information About Project Gutenberg™ electronic works

Professor Michael S. Hart was the originator of the Project
Gutenberg™ concept of a library of electronic works that could be
freely shared with anyone. For forty years, he produced and
distributed Project Gutenberg™ eBooks with only a loose network of
volunteer support.

Project Gutenberg™ eBooks are often created from several printed
editions, all of which are confirmed as not protected by copyright in
the U.S. unless a copyright notice is included. Thus, we do not
necessarily keep eBooks in compliance with any particular paper
edition.

Most people start at our website which has the main PG search
facility: www.gutenberg.org.

This website includes information about Project Gutenberg™,
including how to make donations to the Project Gutenberg Literary
Archive Foundation, how to help produce our new eBooks, and how to
subscribe to our email newsletter to hear about new eBooks.


